"","Fecha","Entidad","id","Cortas","Largas","Total"
"1",2017-01-01,"Aguascalientes",1,0,0,0
"2",2017-01-01,"Baja California",2,26,36,62
"3",2017-01-01,"Baja California Sur",3,0,0,0
"4",2017-01-01,"Campeche",4,2,0,2
"5",2017-01-01,"Chiapas",5,0,1,1
"6",2017-01-01,"Chihuahua",6,0,1,1
"7",2017-01-01,"Ciudad de México",7,38,20,58
"8",2017-01-01,"Coahuila",8,8,3,11
"9",2017-01-01,"Colima",9,0,0,0
"10",2017-01-01,"Durango",10,50,21,71
"11",2017-01-01,"Guanajuato",11,0,0,0
"12",2017-01-01,"Guerrero",12,1,3,4
"13",2017-01-01,"Hidalgo",13,0,0,0
"14",2017-01-01,"Jalisco",14,0,0,0
"15",2017-01-01,"México",15,0,0,0
"16",2017-01-01,"Michoacán",16,10,4,14
"17",2017-01-01,"Morelos",17,0,0,0
"18",2017-01-01,"Nayarit",18,0,0,0
"19",2017-01-01,"Nuevo León",19,0,0,0
"20",2017-01-01,"Oaxaca",20,0,0,0
"21",2017-01-01,"Puebla",21,0,1,1
"22",2017-01-01,"Querétaro",22,0,0,0
"23",2017-01-01,"Quintana Roo",23,0,0,0
"24",2017-01-01,"San Luis Potosí",24,0,0,0
"25",2017-01-01,"Sinaloa",25,1,0,1
"26",2017-01-01,"Sonora",26,0,0,0
"27",2017-01-01,"Tabasco",27,0,0,0
"28",2017-01-01,"Tamaulipas",28,8,5,13
"29",2017-01-01,"Tlaxcala",29,0,0,0
"30",2017-01-01,"Veracruz",30,2,0,2
"31",2017-01-01,"Yucatán",31,2,0,2
"32",2017-01-01,"Zacatecas",32,11,3,14
"33",2017-02-01,"Aguascalientes",1,0,0,0
"34",2017-02-01,"Baja California",2,6,12,18
"35",2017-02-01,"Baja California Sur",3,2,0,2
"36",2017-02-01,"Campeche",4,0,0,0
"37",2017-02-01,"Chiapas",5,1,1,2
"38",2017-02-01,"Chihuahua",6,9,7,16
"39",2017-02-01,"Ciudad de México",7,51,9,60
"40",2017-02-01,"Coahuila",8,42,24,66
"41",2017-02-01,"Colima",9,0,0,0
"42",2017-02-01,"Durango",10,28,3,31
"43",2017-02-01,"Guanajuato",11,0,0,0
"44",2017-02-01,"Guerrero",12,9,15,24
"45",2017-02-01,"Hidalgo",13,0,0,0
"46",2017-02-01,"Jalisco",14,0,1,1
"47",2017-02-01,"México",15,0,0,0
"48",2017-02-01,"Michoacán",16,16,7,23
"49",2017-02-01,"Morelos",17,0,0,0
"50",2017-02-01,"Nayarit",18,0,0,0
"51",2017-02-01,"Nuevo León",19,0,0,0
"52",2017-02-01,"Oaxaca",20,6,6,12
"53",2017-02-01,"Puebla",21,7,3,10
"54",2017-02-01,"Querétaro",22,0,0,0
"55",2017-02-01,"Quintana Roo",23,0,0,0
"56",2017-02-01,"San Luis Potosí",24,0,0,0
"57",2017-02-01,"Sinaloa",25,34,11,45
"58",2017-02-01,"Sonora",26,0,0,0
"59",2017-02-01,"Tabasco",27,1,0,1
"60",2017-02-01,"Tamaulipas",28,20,13,33
"61",2017-02-01,"Tlaxcala",29,0,0,0
"62",2017-02-01,"Veracruz",30,13,6,19
"63",2017-02-01,"Yucatán",31,2,0,2
"64",2017-02-01,"Zacatecas",32,7,0,7
"65",2017-03-01,"Aguascalientes",1,0,0,0
"66",2017-03-01,"Baja California",2,0,0,0
"67",2017-03-01,"Baja California Sur",3,0,1,1
"68",2017-03-01,"Campeche",4,0,0,0
"69",2017-03-01,"Chiapas",5,0,0,0
"70",2017-03-01,"Chihuahua",6,31,11,42
"71",2017-03-01,"Ciudad de México",7,22,8,30
"72",2017-03-01,"Coahuila",8,34,15,49
"73",2017-03-01,"Colima",9,0,0,0
"74",2017-03-01,"Durango",10,11,9,20
"75",2017-03-01,"Guanajuato",11,0,0,0
"76",2017-03-01,"Guerrero",12,5,2,7
"77",2017-03-01,"Hidalgo",13,4,1,5
"78",2017-03-01,"Jalisco",14,2,0,2
"79",2017-03-01,"México",15,134,62,196
"80",2017-03-01,"Michoacán",16,8,1,9
"81",2017-03-01,"Morelos",17,0,0,0
"82",2017-03-01,"Nayarit",18,0,0,0
"83",2017-03-01,"Nuevo León",19,17,13,30
"84",2017-03-01,"Oaxaca",20,11,14,25
"85",2017-03-01,"Puebla",21,10,1,11
"86",2017-03-01,"Querétaro",22,44,64,108
"87",2017-03-01,"Quintana Roo",23,0,0,0
"88",2017-03-01,"San Luis Potosí",24,0,0,0
"89",2017-03-01,"Sinaloa",25,0,0,0
"90",2017-03-01,"Sonora",26,0,0,0
"91",2017-03-01,"Tabasco",27,1,0,1
"92",2017-03-01,"Tamaulipas",28,60,39,99
"93",2017-03-01,"Tlaxcala",29,0,0,0
"94",2017-03-01,"Veracruz",30,27,8,35
"95",2017-03-01,"Yucatán",31,0,0,0
"96",2017-03-01,"Zacatecas",32,16,15,31
"97",2017-04-01,"Aguascalientes",1,0,0,0
"98",2017-04-01,"Baja California",2,0,0,0
"99",2017-04-01,"Baja California Sur",3,0,0,0
"100",2017-04-01,"Campeche",4,0,0,0
"101",2017-04-01,"Chiapas",5,0,2,2
"102",2017-04-01,"Chihuahua",6,4,1,5
"103",2017-04-01,"Ciudad de México",7,35,10,45
"104",2017-04-01,"Coahuila",8,2,0,2
"105",2017-04-01,"Colima",9,0,0,0
"106",2017-04-01,"Durango",10,41,16,57
"107",2017-04-01,"Guanajuato",11,0,0,0
"108",2017-04-01,"Guerrero",12,1,0,1
"109",2017-04-01,"Hidalgo",13,0,0,0
"110",2017-04-01,"Jalisco",14,60,35,95
"111",2017-04-01,"México",15,0,0,0
"112",2017-04-01,"Michoacán",16,12,16,28
"113",2017-04-01,"Morelos",17,0,0,0
"114",2017-04-01,"Nayarit",18,0,0,0
"115",2017-04-01,"Nuevo León",19,9,6,15
"116",2017-04-01,"Oaxaca",20,2,5,7
"117",2017-04-01,"Puebla",21,0,0,0
"118",2017-04-01,"Querétaro",22,7,11,18
"119",2017-04-01,"Quintana Roo",23,0,0,0
"120",2017-04-01,"San Luis Potosí",24,41,6,47
"121",2017-04-01,"Sinaloa",25,39,14,53
"122",2017-04-01,"Sonora",26,0,0,0
"123",2017-04-01,"Tabasco",27,2,1,3
"124",2017-04-01,"Tamaulipas",28,26,15,41
"125",2017-04-01,"Tlaxcala",29,0,0,0
"126",2017-04-01,"Veracruz",30,8,3,11
"127",2017-04-01,"Yucatán",31,0,0,0
"128",2017-04-01,"Zacatecas",32,0,0,0
"129",2017-05-01,"Aguascalientes",1,11,5,16
"130",2017-05-01,"Baja California",2,0,0,0
"131",2017-05-01,"Baja California Sur",3,0,5,5
"132",2017-05-01,"Campeche",4,0,0,0
"133",2017-05-01,"Chiapas",5,0,0,0
"134",2017-05-01,"Chihuahua",6,1,0,1
"135",2017-05-01,"Ciudad de México",7,71,19,90
"136",2017-05-01,"Coahuila",8,0,0,0
"137",2017-05-01,"Colima",9,3,0,3
"138",2017-05-01,"Durango",10,24,12,36
"139",2017-05-01,"Guanajuato",11,46,15,61
"140",2017-05-01,"Guerrero",12,12,2,14
"141",2017-05-01,"Hidalgo",13,0,0,0
"142",2017-05-01,"Jalisco",14,107,63,170
"143",2017-05-01,"México",15,0,0,0
"144",2017-05-01,"Michoacán",16,5,0,5
"145",2017-05-01,"Morelos",17,0,0,0
"146",2017-05-01,"Nayarit",18,0,0,0
"147",2017-05-01,"Nuevo León",19,15,9,24
"148",2017-05-01,"Oaxaca",20,1,1,2
"149",2017-05-01,"Puebla",21,11,2,13
"150",2017-05-01,"Querétaro",22,0,0,0
"151",2017-05-01,"Quintana Roo",23,3,1,4
"152",2017-05-01,"San Luis Potosí",24,0,0,0
"153",2017-05-01,"Sinaloa",25,56,30,86
"154",2017-05-01,"Sonora",26,7,4,11
"155",2017-05-01,"Tabasco",27,5,1,6
"156",2017-05-01,"Tamaulipas",28,24,22,46
"157",2017-05-01,"Tlaxcala",29,0,0,0
"158",2017-05-01,"Veracruz",30,0,0,0
"159",2017-05-01,"Yucatán",31,0,0,0
"160",2017-05-01,"Zacatecas",32,0,0,0
"161",2017-06-01,"Aguascalientes",1,2,2,4
"162",2017-06-01,"Baja California",2,9,33,42
"163",2017-06-01,"Baja California Sur",3,1,0,1
"164",2017-06-01,"Campeche",4,0,0,0
"165",2017-06-01,"Chiapas",5,106,77,183
"166",2017-06-01,"Chihuahua",6,28,8,36
"167",2017-06-01,"Ciudad de México",7,38,12,50
"168",2017-06-01,"Coahuila",8,65,25,90
"169",2017-06-01,"Colima",9,0,0,0
"170",2017-06-01,"Durango",10,12,14,26
"171",2017-06-01,"Guanajuato",11,4,3,7
"172",2017-06-01,"Guerrero",12,10,9,19
"173",2017-06-01,"Hidalgo",13,0,0,0
"174",2017-06-01,"Jalisco",14,80,60,140
"175",2017-06-01,"México",15,63,19,82
"176",2017-06-01,"Michoacán",16,8,4,12
"177",2017-06-01,"Morelos",17,29,20,49
"178",2017-06-01,"Nayarit",18,0,0,0
"179",2017-06-01,"Nuevo León",19,29,9,38
"180",2017-06-01,"Oaxaca",20,1,1,2
"181",2017-06-01,"Puebla",21,2,0,2
"182",2017-06-01,"Querétaro",22,15,12,27
"183",2017-06-01,"Quintana Roo",23,3,0,3
"184",2017-06-01,"San Luis Potosí",24,0,0,0
"185",2017-06-01,"Sinaloa",25,63,40,103
"186",2017-06-01,"Sonora",26,11,3,14
"187",2017-06-01,"Tabasco",27,12,9,21
"188",2017-06-01,"Tamaulipas",28,18,18,36
"189",2017-06-01,"Tlaxcala",29,13,19,32
"190",2017-06-01,"Veracruz",30,0,0,0
"191",2017-06-01,"Yucatán",31,36,10,46
"192",2017-06-01,"Zacatecas",32,6,5,11
"193",2017-07-01,"Aguascalientes",1,17,2,19
"194",2017-07-01,"Baja California",2,5,41,46
"195",2017-07-01,"Baja California Sur",3,0,0,0
"196",2017-07-01,"Campeche",4,0,0,0
"197",2017-07-01,"Chiapas",5,7,5,12
"198",2017-07-01,"Chihuahua",6,2,0,2
"199",2017-07-01,"Ciudad de México",7,36,5,41
"200",2017-07-01,"Coahuila",8,74,36,110
"201",2017-07-01,"Colima",9,0,0,0
"202",2017-07-01,"Durango",10,2,0,2
"203",2017-07-01,"Guanajuato",11,2,0,2
"204",2017-07-01,"Guerrero",12,7,6,13
"205",2017-07-01,"Hidalgo",13,4,3,7
"206",2017-07-01,"Jalisco",14,33,28,61
"207",2017-07-01,"México",15,68,42,110
"208",2017-07-01,"Michoacán",16,8,6,14
"209",2017-07-01,"Morelos",17,23,7,30
"210",2017-07-01,"Nayarit",18,0,0,0
"211",2017-07-01,"Nuevo León",19,10,7,17
"212",2017-07-01,"Oaxaca",20,6,2,8
"213",2017-07-01,"Puebla",21,1,3,4
"214",2017-07-01,"Querétaro",22,0,0,0
"215",2017-07-01,"Quintana Roo",23,0,0,0
"216",2017-07-01,"San Luis Potosí",24,0,0,0
"217",2017-07-01,"Sinaloa",25,25,11,36
"218",2017-07-01,"Sonora",26,10,1,11
"219",2017-07-01,"Tabasco",27,4,0,4
"220",2017-07-01,"Tamaulipas",28,15,16,31
"221",2017-07-01,"Tlaxcala",29,8,28,36
"222",2017-07-01,"Veracruz",30,2,0,2
"223",2017-07-01,"Yucatán",31,0,0,0
"224",2017-07-01,"Zacatecas",32,59,23,82
"225",2017-08-01,"Aguascalientes",1,7,0,7
"226",2017-08-01,"Baja California",2,13,29,42
"227",2017-08-01,"Baja California Sur",3,0,0,0
"228",2017-08-01,"Campeche",4,0,0,0
"229",2017-08-01,"Chiapas",5,67,55,122
"230",2017-08-01,"Chihuahua",6,3,0,3
"231",2017-08-01,"Ciudad de México",7,27,8,35
"232",2017-08-01,"Coahuila",8,80,26,106
"233",2017-08-01,"Colima",9,0,0,0
"234",2017-08-01,"Durango",10,11,4,15
"235",2017-08-01,"Guanajuato",11,0,0,0
"236",2017-08-01,"Guerrero",12,10,2,12
"237",2017-08-01,"Hidalgo",13,3,2,5
"238",2017-08-01,"Jalisco",14,0,0,0
"239",2017-08-01,"México",15,202,79,281
"240",2017-08-01,"Michoacán",16,2,0,2
"241",2017-08-01,"Morelos",17,15,11,26
"242",2017-08-01,"Nayarit",18,0,0,0
"243",2017-08-01,"Nuevo León",19,25,27,52
"244",2017-08-01,"Oaxaca",20,1,1,2
"245",2017-08-01,"Puebla",21,0,0,0
"246",2017-08-01,"Querétaro",22,9,10,19
"247",2017-08-01,"Quintana Roo",23,2,2,4
"248",2017-08-01,"San Luis Potosí",24,66,6,72
"249",2017-08-01,"Sinaloa",25,26,25,51
"250",2017-08-01,"Sonora",26,0,1,1
"251",2017-08-01,"Tabasco",27,5,0,5
"252",2017-08-01,"Tamaulipas",28,19,6,25
"253",2017-08-01,"Tlaxcala",29,0,0,0
"254",2017-08-01,"Veracruz",30,9,0,9
"255",2017-08-01,"Yucatán",31,1,0,1
"256",2017-08-01,"Zacatecas",32,0,0,0
"257",2017-09-01,"Aguascalientes",1,11,6,17
"258",2017-09-01,"Baja California",2,15,10,25
"259",2017-09-01,"Baja California Sur",3,0,0,0
"260",2017-09-01,"Campeche",4,0,1,1
"261",2017-09-01,"Chiapas",5,0,0,0
"262",2017-09-01,"Chihuahua",6,2,4,6
"263",2017-09-01,"Ciudad de México",7,9,2,11
"264",2017-09-01,"Coahuila",8,74,13,87
"265",2017-09-01,"Colima",9,0,2,2
"266",2017-09-01,"Durango",10,30,17,47
"267",2017-09-01,"Guanajuato",11,59,13,72
"268",2017-09-01,"Guerrero",12,4,5,9
"269",2017-09-01,"Hidalgo",13,0,0,0
"270",2017-09-01,"Jalisco",14,2,4,6
"271",2017-09-01,"México",15,50,36,86
"272",2017-09-01,"Michoacán",16,0,0,0
"273",2017-09-01,"Morelos",17,0,0,0
"274",2017-09-01,"Nayarit",18,0,0,0
"275",2017-09-01,"Nuevo León",19,31,12,43
"276",2017-09-01,"Oaxaca",20,0,0,0
"277",2017-09-01,"Puebla",21,0,0,0
"278",2017-09-01,"Querétaro",22,10,4,14
"279",2017-09-01,"Quintana Roo",23,0,1,1
"280",2017-09-01,"San Luis Potosí",24,6,0,6
"281",2017-09-01,"Sinaloa",25,46,21,67
"282",2017-09-01,"Sonora",26,7,2,9
"283",2017-09-01,"Tabasco",27,2,1,3
"284",2017-09-01,"Tamaulipas",28,6,12,18
"285",2017-09-01,"Tlaxcala",29,0,0,0
"286",2017-09-01,"Veracruz",30,4,1,5
"287",2017-09-01,"Yucatán",31,0,0,0
"288",2017-09-01,"Zacatecas",32,102,35,137
"289",2017-10-01,"Aguascalientes",1,14,0,14
"290",2017-10-01,"Baja California",2,17,14,31
"291",2017-10-01,"Baja California Sur",3,0,1,1
"292",2017-10-01,"Campeche",4,0,0,0
"293",2017-10-01,"Chiapas",5,2,3,5
"294",2017-10-01,"Chihuahua",6,2,0,2
"295",2017-10-01,"Ciudad de México",7,25,12,37
"296",2017-10-01,"Coahuila",8,12,5,17
"297",2017-10-01,"Colima",9,3,2,5
"298",2017-10-01,"Durango",10,18,15,33
"299",2017-10-01,"Guanajuato",11,0,0,0
"300",2017-10-01,"Guerrero",12,2,3,5
"301",2017-10-01,"Hidalgo",13,0,0,0
"302",2017-10-01,"Jalisco",14,0,0,0
"303",2017-10-01,"México",15,1,3,4
"304",2017-10-01,"Michoacán",16,1,0,1
"305",2017-10-01,"Morelos",17,0,0,0
"306",2017-10-01,"Nayarit",18,0,0,0
"307",2017-10-01,"Nuevo León",19,12,12,24
"308",2017-10-01,"Oaxaca",20,0,0,0
"309",2017-10-01,"Puebla",21,0,0,0
"310",2017-10-01,"Querétaro",22,0,0,0
"311",2017-10-01,"Quintana Roo",23,0,0,0
"312",2017-10-01,"San Luis Potosí",24,0,0,0
"313",2017-10-01,"Sinaloa",25,77,13,90
"314",2017-10-01,"Sonora",26,29,12,41
"315",2017-10-01,"Tabasco",27,0,0,0
"316",2017-10-01,"Tamaulipas",28,21,8,29
"317",2017-10-01,"Tlaxcala",29,0,0,0
"318",2017-10-01,"Veracruz",30,0,0,0
"319",2017-10-01,"Yucatán",31,0,0,0
"320",2017-10-01,"Zacatecas",32,82,36,118
"321",2017-11-01,"Aguascalientes",1,0,0,0
"322",2017-11-01,"Baja California",2,12,10,22
"323",2017-11-01,"Baja California Sur",3,1,0,1
"324",2017-11-01,"Campeche",4,0,0,0
"325",2017-11-01,"Chiapas",5,0,0,0
"326",2017-11-01,"Chihuahua",6,13,34,47
"327",2017-11-01,"Ciudad de México",7,15,8,23
"328",2017-11-01,"Coahuila",8,4,0,4
"329",2017-11-01,"Colima",9,0,0,0
"330",2017-11-01,"Durango",10,6,4,10
"331",2017-11-01,"Guanajuato",11,14,19,33
"332",2017-11-01,"Guerrero",12,2,3,5
"333",2017-11-01,"Hidalgo",13,0,0,0
"334",2017-11-01,"Jalisco",14,0,0,0
"335",2017-11-01,"México",15,0,0,0
"336",2017-11-01,"Michoacán",16,0,0,0
"337",2017-11-01,"Morelos",17,0,0,0
"338",2017-11-01,"Nayarit",18,0,0,0
"339",2017-11-01,"Nuevo León",19,9,4,13
"340",2017-11-01,"Oaxaca",20,0,0,0
"341",2017-11-01,"Puebla",21,0,0,0
"342",2017-11-01,"Querétaro",22,0,0,0
"343",2017-11-01,"Quintana Roo",23,3,0,3
"344",2017-11-01,"San Luis Potosí",24,34,9,43
"345",2017-11-01,"Sinaloa",25,12,7,19
"346",2017-11-01,"Sonora",26,30,5,35
"347",2017-11-01,"Tabasco",27,0,0,0
"348",2017-11-01,"Tamaulipas",28,13,7,20
"349",2017-11-01,"Tlaxcala",29,0,0,0
"350",2017-11-01,"Veracruz",30,4,0,4
"351",2017-11-01,"Yucatán",31,0,0,0
"352",2017-11-01,"Zacatecas",32,19,8,27
"353",2017-12-01,"Aguascalientes",1,0,0,0
"354",2017-12-01,"Baja California",2,21,26,47
"355",2017-12-01,"Baja California Sur",3,0,0,0
"356",2017-12-01,"Campeche",4,0,0,0
"357",2017-12-01,"Chiapas",5,0,0,0
"358",2017-12-01,"Chihuahua",6,15,18,33
"359",2017-12-01,"Ciudad de México",7,5,7,12
"360",2017-12-01,"Coahuila",8,3,2,5
"361",2017-12-01,"Colima",9,0,0,0
"362",2017-12-01,"Durango",10,15,5,20
"363",2017-12-01,"Guanajuato",11,124,101,225
"364",2017-12-01,"Guerrero",12,3,1,4
"365",2017-12-01,"Hidalgo",13,2,3,5
"366",2017-12-01,"Jalisco",14,2,2,4
"367",2017-12-01,"México",15,0,0,0
"368",2017-12-01,"Michoacán",16,0,0,0
"369",2017-12-01,"Morelos",17,0,0,0
"370",2017-12-01,"Nayarit",18,0,0,0
"371",2017-12-01,"Nuevo León",19,13,4,17
"372",2017-12-01,"Oaxaca",20,0,0,0
"373",2017-12-01,"Puebla",21,2,0,2
"374",2017-12-01,"Querétaro",22,0,0,0
"375",2017-12-01,"Quintana Roo",23,0,0,0
"376",2017-12-01,"San Luis Potosí",24,11,1,12
"377",2017-12-01,"Sinaloa",25,0,0,0
"378",2017-12-01,"Sonora",26,0,0,0
"379",2017-12-01,"Tabasco",27,0,0,0
"380",2017-12-01,"Tamaulipas",28,5,11,16
"381",2017-12-01,"Tlaxcala",29,0,0,0
"382",2017-12-01,"Veracruz",30,0,0,0
"383",2017-12-01,"Yucatán",31,0,0,0
"384",2017-12-01,"Zacatecas",32,20,9,29
"385",2018-01-01,"Aguascalientes",1,0,0,0
"386",2018-01-01,"Baja California",2,27,14,41
"387",2018-01-01,"Baja California Sur",3,0,0,0
"388",2018-01-01,"Campeche",4,0,0,0
"389",2018-01-01,"Chiapas",5,0,0,0
"390",2018-01-01,"Chihuahua",6,0,0,0
"391",2018-01-01,"Ciudad de México",7,68,28,96
"392",2018-01-01,"Coahuila",8,122,68,190
"393",2018-01-01,"Colima",9,0,0,0
"394",2018-01-01,"Durango",10,14,7,21
"395",2018-01-01,"Guanajuato",11,20,19,39
"396",2018-01-01,"Guerrero",12,1,1,2
"397",2018-01-01,"Hidalgo",13,0,0,0
"398",2018-01-01,"Jalisco",14,0,0,0
"399",2018-01-01,"México",15,0,0,0
"400",2018-01-01,"Michoacán",16,0,0,0
"401",2018-01-01,"Morelos",17,0,0,0
"402",2018-01-01,"Nayarit",18,0,0,0
"403",2018-01-01,"Nuevo León",19,0,0,0
"404",2018-01-01,"Oaxaca",20,0,0,0
"405",2018-01-01,"Puebla",21,0,0,0
"406",2018-01-01,"Querétaro",22,0,0,0
"407",2018-01-01,"Quintana Roo",23,0,0,0
"408",2018-01-01,"San Luis Potosí",24,0,0,0
"409",2018-01-01,"Sinaloa",25,0,0,0
"410",2018-01-01,"Sonora",26,0,0,0
"411",2018-01-01,"Tabasco",27,1,0,1
"412",2018-01-01,"Tamaulipas",28,2,1,3
"413",2018-01-01,"Tlaxcala",29,0,0,0
"414",2018-01-01,"Veracruz",30,2,0,2
"415",2018-01-01,"Yucatán",31,0,0,0
"416",2018-01-01,"Zacatecas",32,32,5,37
"417",2018-02-01,"Aguascalientes",1,0,0,0
"418",2018-02-01,"Baja California",2,2,0,2
"419",2018-02-01,"Baja California Sur",3,0,0,0
"420",2018-02-01,"Campeche",4,0,0,0
"421",2018-02-01,"Chiapas",5,1,0,1
"422",2018-02-01,"Chihuahua",6,0,0,0
"423",2018-02-01,"Ciudad de México",7,17,11,28
"424",2018-02-01,"Coahuila",8,185,93,278
"425",2018-02-01,"Colima",9,1,0,1
"426",2018-02-01,"Durango",10,15,1,16
"427",2018-02-01,"Guanajuato",11,0,0,0
"428",2018-02-01,"Guerrero",12,15,2,17
"429",2018-02-01,"Hidalgo",13,0,0,0
"430",2018-02-01,"Jalisco",14,0,0,0
"431",2018-02-01,"México",15,0,0,0
"432",2018-02-01,"Michoacán",16,0,0,0
"433",2018-02-01,"Morelos",17,0,0,0
"434",2018-02-01,"Nayarit",18,0,0,0
"435",2018-02-01,"Nuevo León",19,0,0,0
"436",2018-02-01,"Oaxaca",20,0,0,0
"437",2018-02-01,"Puebla",21,0,0,0
"438",2018-02-01,"Querétaro",22,0,0,0
"439",2018-02-01,"Quintana Roo",23,1,0,1
"440",2018-02-01,"San Luis Potosí",24,3,1,4
"441",2018-02-01,"Sinaloa",25,29,4,33
"442",2018-02-01,"Sonora",26,0,0,0
"443",2018-02-01,"Tabasco",27,1,0,1
"444",2018-02-01,"Tamaulipas",28,17,14,31
"445",2018-02-01,"Tlaxcala",29,0,0,0
"446",2018-02-01,"Veracruz",30,2,0,2
"447",2018-02-01,"Yucatán",31,0,0,0
"448",2018-02-01,"Zacatecas",32,56,10,66
"449",2018-03-01,"Aguascalientes",1,0,0,0
"450",2018-03-01,"Baja California",2,0,0,0
"451",2018-03-01,"Baja California Sur",3,0,0,0
"452",2018-03-01,"Campeche",4,0,0,0
"453",2018-03-01,"Chiapas",5,0,0,0
"454",2018-03-01,"Chihuahua",6,54,20,74
"455",2018-03-01,"Ciudad de México",7,5,13,18
"456",2018-03-01,"Coahuila",8,65,31,96
"457",2018-03-01,"Colima",9,0,0,0
"458",2018-03-01,"Durango",10,34,11,45
"459",2018-03-01,"Guanajuato",11,0,0,0
"460",2018-03-01,"Guerrero",12,6,4,10
"461",2018-03-01,"Hidalgo",13,0,0,0
"462",2018-03-01,"Jalisco",14,0,0,0
"463",2018-03-01,"México",15,0,0,0
"464",2018-03-01,"Michoacán",16,0,0,0
"465",2018-03-01,"Morelos",17,0,0,0
"466",2018-03-01,"Nayarit",18,0,0,0
"467",2018-03-01,"Nuevo León",19,0,0,0
"468",2018-03-01,"Oaxaca",20,0,0,0
"469",2018-03-01,"Puebla",21,0,0,0
"470",2018-03-01,"Querétaro",22,33,15,48
"471",2018-03-01,"Quintana Roo",23,0,0,0
"472",2018-03-01,"San Luis Potosí",24,47,12,59
"473",2018-03-01,"Sinaloa",25,8,7,15
"474",2018-03-01,"Sonora",26,0,0,0
"475",2018-03-01,"Tabasco",27,0,1,1
"476",2018-03-01,"Tamaulipas",28,7,3,10
"477",2018-03-01,"Tlaxcala",29,0,0,0
"478",2018-03-01,"Veracruz",30,11,0,11
"479",2018-03-01,"Yucatán",31,0,0,0
"480",2018-03-01,"Zacatecas",32,19,3,22
"481",2018-04-01,"Aguascalientes",1,0,0,0
"482",2018-04-01,"Baja California",2,0,0,0
"483",2018-04-01,"Baja California Sur",3,0,0,0
"484",2018-04-01,"Campeche",4,0,0,0
"485",2018-04-01,"Chiapas",5,0,0,0
"486",2018-04-01,"Chihuahua",6,0,0,0
"487",2018-04-01,"Ciudad de México",7,0,0,0
"488",2018-04-01,"Coahuila",8,0,0,0
"489",2018-04-01,"Colima",9,0,0,0
"490",2018-04-01,"Durango",10,0,0,0
"491",2018-04-01,"Guanajuato",11,0,0,0
"492",2018-04-01,"Guerrero",12,0,0,0
"493",2018-04-01,"Hidalgo",13,0,0,0
"494",2018-04-01,"Jalisco",14,0,0,0
"495",2018-04-01,"México",15,0,0,0
"496",2018-04-01,"Michoacán",16,0,0,0
"497",2018-04-01,"Morelos",17,0,0,0
"498",2018-04-01,"Nayarit",18,0,0,0
"499",2018-04-01,"Nuevo León",19,0,0,0
"500",2018-04-01,"Oaxaca",20,0,0,0
"501",2018-04-01,"Puebla",21,0,0,0
"502",2018-04-01,"Querétaro",22,0,0,0
"503",2018-04-01,"Quintana Roo",23,0,0,0
"504",2018-04-01,"San Luis Potosí",24,0,0,0
"505",2018-04-01,"Sinaloa",25,0,0,0
"506",2018-04-01,"Sonora",26,0,0,0
"507",2018-04-01,"Tabasco",27,0,0,0
"508",2018-04-01,"Tamaulipas",28,1,1,2
"509",2018-04-01,"Tlaxcala",29,0,0,0
"510",2018-04-01,"Veracruz",30,0,0,0
"511",2018-04-01,"Yucatán",31,0,0,0
"512",2018-04-01,"Zacatecas",32,0,0,0
"513",2018-05-01,"Aguascalientes",1,0,0,0
"514",2018-05-01,"Baja California",2,0,0,0
"515",2018-05-01,"Baja California Sur",3,0,0,0
"516",2018-05-01,"Campeche",4,0,0,0
"517",2018-05-01,"Chiapas",5,0,0,0
"518",2018-05-01,"Chihuahua",6,0,0,0
"519",2018-05-01,"Ciudad de México",7,0,0,0
"520",2018-05-01,"Coahuila",8,0,0,0
"521",2018-05-01,"Colima",9,0,0,0
"522",2018-05-01,"Durango",10,0,0,0
"523",2018-05-01,"Guanajuato",11,0,0,0
"524",2018-05-01,"Guerrero",12,0,0,0
"525",2018-05-01,"Hidalgo",13,0,0,0
"526",2018-05-01,"Jalisco",14,0,0,0
"527",2018-05-01,"México",15,0,0,0
"528",2018-05-01,"Michoacán",16,0,0,0
"529",2018-05-01,"Morelos",17,0,0,0
"530",2018-05-01,"Nayarit",18,0,0,0
"531",2018-05-01,"Nuevo León",19,0,0,0
"532",2018-05-01,"Oaxaca",20,0,0,0
"533",2018-05-01,"Puebla",21,0,0,0
"534",2018-05-01,"Querétaro",22,0,0,0
"535",2018-05-01,"Quintana Roo",23,0,0,0
"536",2018-05-01,"San Luis Potosí",24,0,0,0
"537",2018-05-01,"Sinaloa",25,0,0,0
"538",2018-05-01,"Sonora",26,0,0,0
"539",2018-05-01,"Tabasco",27,0,0,0
"540",2018-05-01,"Tamaulipas",28,0,0,0
"541",2018-05-01,"Tlaxcala",29,0,0,0
"542",2018-05-01,"Veracruz",30,0,0,0
"543",2018-05-01,"Yucatán",31,0,0,0
"544",2018-05-01,"Zacatecas",32,0,0,0
"545",2018-06-01,"Aguascalientes",1,0,0,0
"546",2018-06-01,"Baja California",2,0,0,0
"547",2018-06-01,"Baja California Sur",3,0,0,0
"548",2018-06-01,"Campeche",4,0,0,0
"549",2018-06-01,"Chiapas",5,0,0,0
"550",2018-06-01,"Chihuahua",6,0,0,0
"551",2018-06-01,"Ciudad de México",7,0,0,0
"552",2018-06-01,"Coahuila",8,0,0,0
"553",2018-06-01,"Colima",9,0,0,0
"554",2018-06-01,"Durango",10,0,0,0
"555",2018-06-01,"Guanajuato",11,0,0,0
"556",2018-06-01,"Guerrero",12,0,0,0
"557",2018-06-01,"Hidalgo",13,0,0,0
"558",2018-06-01,"Jalisco",14,0,0,0
"559",2018-06-01,"México",15,0,0,0
"560",2018-06-01,"Michoacán",16,0,0,0
"561",2018-06-01,"Morelos",17,0,0,0
"562",2018-06-01,"Nayarit",18,0,0,0
"563",2018-06-01,"Nuevo León",19,0,0,0
"564",2018-06-01,"Oaxaca",20,0,0,0
"565",2018-06-01,"Puebla",21,0,0,0
"566",2018-06-01,"Querétaro",22,0,0,0
"567",2018-06-01,"Quintana Roo",23,0,0,0
"568",2018-06-01,"San Luis Potosí",24,0,0,0
"569",2018-06-01,"Sinaloa",25,0,0,0
"570",2018-06-01,"Sonora",26,0,0,0
"571",2018-06-01,"Tabasco",27,0,0,0
"572",2018-06-01,"Tamaulipas",28,0,0,0
"573",2018-06-01,"Tlaxcala",29,0,0,0
"574",2018-06-01,"Veracruz",30,0,0,0
"575",2018-06-01,"Yucatán",31,0,0,0
"576",2018-06-01,"Zacatecas",32,0,0,0
"577",2018-07-01,"Aguascalientes",1,0,0,0
"578",2018-07-01,"Baja California",2,44,7,51
"579",2018-07-01,"Baja California Sur",3,0,0,0
"580",2018-07-01,"Campeche",4,0,0,0
"581",2018-07-01,"Chiapas",5,0,1,1
"582",2018-07-01,"Chihuahua",6,6,7,13
"583",2018-07-01,"Ciudad de México",7,5,0,5
"584",2018-07-01,"Coahuila",8,0,0,0
"585",2018-07-01,"Colima",9,1,0,1
"586",2018-07-01,"Durango",10,1,0,1
"587",2018-07-01,"Guanajuato",11,40,17,57
"588",2018-07-01,"Guerrero",12,2,0,2
"589",2018-07-01,"Hidalgo",13,0,0,0
"590",2018-07-01,"Jalisco",14,0,0,0
"591",2018-07-01,"México",15,0,0,0
"592",2018-07-01,"Michoacán",16,0,0,0
"593",2018-07-01,"Morelos",17,0,0,0
"594",2018-07-01,"Nayarit",18,0,0,0
"595",2018-07-01,"Nuevo León",19,17,9,26
"596",2018-07-01,"Oaxaca",20,0,0,0
"597",2018-07-01,"Puebla",21,1,0,1
"598",2018-07-01,"Querétaro",22,0,0,0
"599",2018-07-01,"Quintana Roo",23,0,0,0
"600",2018-07-01,"San Luis Potosí",24,0,0,0
"601",2018-07-01,"Sinaloa",25,7,2,9
"602",2018-07-01,"Sonora",26,0,0,0
"603",2018-07-01,"Tabasco",27,4,2,6
"604",2018-07-01,"Tamaulipas",28,3,6,9
"605",2018-07-01,"Tlaxcala",29,6,4,10
"606",2018-07-01,"Veracruz",30,0,0,0
"607",2018-07-01,"Yucatán",31,0,0,0
"608",2018-07-01,"Zacatecas",32,30,17,47
"609",2018-08-01,"Aguascalientes",1,5,3,8
"610",2018-08-01,"Baja California",2,41,30,71
"611",2018-08-01,"Baja California Sur",3,1,0,1
"612",2018-08-01,"Campeche",4,0,0,0
"613",2018-08-01,"Chiapas",5,64,42,106
"614",2018-08-01,"Chihuahua",6,58,15,73
"615",2018-08-01,"Ciudad de México",7,182,52,234
"616",2018-08-01,"Coahuila",8,60,38,98
"617",2018-08-01,"Colima",9,0,0,0
"618",2018-08-01,"Durango",10,18,9,27
"619",2018-08-01,"Guanajuato",11,29,11,40
"620",2018-08-01,"Guerrero",12,2,1,3
"621",2018-08-01,"Hidalgo",13,0,0,0
"622",2018-08-01,"Jalisco",14,0,0,0
"623",2018-08-01,"México",15,215,95,310
"624",2018-08-01,"Michoacán",16,0,0,0
"625",2018-08-01,"Morelos",17,3,0,3
"626",2018-08-01,"Nayarit",18,0,0,0
"627",2018-08-01,"Nuevo León",19,22,13,35
"628",2018-08-01,"Oaxaca",20,0,0,0
"629",2018-08-01,"Puebla",21,1,0,1
"630",2018-08-01,"Querétaro",22,10,1,11
"631",2018-08-01,"Quintana Roo",23,2,0,2
"632",2018-08-01,"San Luis Potosí",24,1,0,1
"633",2018-08-01,"Sinaloa",25,13,7,20
"634",2018-08-01,"Sonora",26,0,0,0
"635",2018-08-01,"Tabasco",27,8,1,9
"636",2018-08-01,"Tamaulipas",28,123,57,180
"637",2018-08-01,"Tlaxcala",29,28,18,46
"638",2018-08-01,"Veracruz",30,4,1,5
"639",2018-08-01,"Yucatán",31,0,0,0
"640",2018-08-01,"Zacatecas",32,20,9,29
"641",2018-09-01,"Aguascalientes",1,25,3,28
"642",2018-09-01,"Baja California",2,12,20,32
"643",2018-09-01,"Baja California Sur",3,0,0,0
"644",2018-09-01,"Campeche",4,0,0,0
"645",2018-09-01,"Chiapas",5,0,0,0
"646",2018-09-01,"Chihuahua",6,1,1,2
"647",2018-09-01,"Ciudad de México",7,54,9,63
"648",2018-09-01,"Coahuila",8,24,20,44
"649",2018-09-01,"Colima",9,0,0,0
"650",2018-09-01,"Durango",10,0,0,0
"651",2018-09-01,"Guanajuato",11,0,0,0
"652",2018-09-01,"Guerrero",12,0,0,0
"653",2018-09-01,"Hidalgo",13,0,0,0
"654",2018-09-01,"Jalisco",14,0,0,0
"655",2018-09-01,"México",15,140,38,178
"656",2018-09-01,"Michoacán",16,0,0,0
"657",2018-09-01,"Morelos",17,24,9,33
"658",2018-09-01,"Nayarit",18,0,0,0
"659",2018-09-01,"Nuevo León",19,8,4,12
"660",2018-09-01,"Oaxaca",20,0,0,0
"661",2018-09-01,"Puebla",21,1,2,3
"662",2018-09-01,"Querétaro",22,1,0,1
"663",2018-09-01,"Quintana Roo",23,1,0,1
"664",2018-09-01,"San Luis Potosí",24,10,1,11
"665",2018-09-01,"Sinaloa",25,0,0,0
"666",2018-09-01,"Sonora",26,0,0,0
"667",2018-09-01,"Tabasco",27,1,0,1
"668",2018-09-01,"Tamaulipas",28,22,10,32
"669",2018-09-01,"Tlaxcala",29,5,1,6
"670",2018-09-01,"Veracruz",30,20,9,29
"671",2018-09-01,"Yucatán",31,0,0,0
"672",2018-09-01,"Zacatecas",32,34,12,46
"673",2018-10-01,"Aguascalientes",1,18,3,21
"674",2018-10-01,"Baja California",2,2,15,17
"675",2018-10-01,"Baja California Sur",3,0,0,0
"676",2018-10-01,"Campeche",4,0,0,0
"677",2018-10-01,"Chiapas",5,0,0,0
"678",2018-10-01,"Chihuahua",6,45,53,98
"679",2018-10-01,"Ciudad de México",7,47,10,57
"680",2018-10-01,"Coahuila",8,20,25,45
"681",2018-10-01,"Colima",9,0,0,0
"682",2018-10-01,"Durango",10,5,2,7
"683",2018-10-01,"Guanajuato",11,126,49,175
"684",2018-10-01,"Guerrero",12,0,0,0
"685",2018-10-01,"Hidalgo",13,0,0,0
"686",2018-10-01,"Jalisco",14,0,0,0
"687",2018-10-01,"México",15,112,38,150
"688",2018-10-01,"Michoacán",16,0,0,0
"689",2018-10-01,"Morelos",17,5,3,8
"690",2018-10-01,"Nayarit",18,0,0,0
"691",2018-10-01,"Nuevo León",19,13,5,18
"692",2018-10-01,"Oaxaca",20,0,0,0
"693",2018-10-01,"Puebla",21,0,0,0
"694",2018-10-01,"Querétaro",22,0,0,0
"695",2018-10-01,"Quintana Roo",23,0,0,0
"696",2018-10-01,"San Luis Potosí",24,36,7,43
"697",2018-10-01,"Sinaloa",25,2,3,5
"698",2018-10-01,"Sonora",26,0,0,0
"699",2018-10-01,"Tabasco",27,2,1,3
"700",2018-10-01,"Tamaulipas",28,0,0,0
"701",2018-10-01,"Tlaxcala",29,0,0,0
"702",2018-10-01,"Veracruz",30,0,0,0
"703",2018-10-01,"Yucatán",31,0,0,0
"704",2018-10-01,"Zacatecas",32,17,3,20
"705",2018-11-01,"Aguascalientes",1,0,0,0
"706",2018-11-01,"Baja California",2,3,6,9
"707",2018-11-01,"Baja California Sur",3,0,0,0
"708",2018-11-01,"Campeche",4,0,0,0
"709",2018-11-01,"Chiapas",5,0,0,0
"710",2018-11-01,"Chihuahua",6,8,6,14
"711",2018-11-01,"Ciudad de México",7,37,10,47
"712",2018-11-01,"Coahuila",8,20,9,29
"713",2018-11-01,"Colima",9,0,0,0
"714",2018-11-01,"Durango",10,1,0,1
"715",2018-11-01,"Guanajuato",11,0,0,0
"716",2018-11-01,"Guerrero",12,0,0,0
"717",2018-11-01,"Hidalgo",13,0,0,0
"718",2018-11-01,"Jalisco",14,0,0,0
"719",2018-11-01,"México",15,71,24,95
"720",2018-11-01,"Michoacán",16,0,0,0
"721",2018-11-01,"Morelos",17,1,0,1
"722",2018-11-01,"Nayarit",18,0,0,0
"723",2018-11-01,"Nuevo León",19,14,5,19
"724",2018-11-01,"Oaxaca",20,0,0,0
"725",2018-11-01,"Puebla",21,0,0,0
"726",2018-11-01,"Querétaro",22,0,0,0
"727",2018-11-01,"Quintana Roo",23,0,0,0
"728",2018-11-01,"San Luis Potosí",24,4,1,5
"729",2018-11-01,"Sinaloa",25,10,2,12
"730",2018-11-01,"Sonora",26,0,0,0
"731",2018-11-01,"Tabasco",27,0,0,0
"732",2018-11-01,"Tamaulipas",28,2,0,2
"733",2018-11-01,"Tlaxcala",29,0,0,0
"734",2018-11-01,"Veracruz",30,0,0,0
"735",2018-11-01,"Yucatán",31,0,0,0
"736",2018-11-01,"Zacatecas",32,9,0,9
"737",2018-12-01,"Aguascalientes",1,0,0,0
"738",2018-12-01,"Baja California",2,4,6,10
"739",2018-12-01,"Baja California Sur",3,0,0,0
"740",2018-12-01,"Campeche",4,0,0,0
"741",2018-12-01,"Chiapas",5,0,0,0
"742",2018-12-01,"Chihuahua",6,0,0,0
"743",2018-12-01,"Ciudad de México",7,0,0,0
"744",2018-12-01,"Coahuila",8,0,0,0
"745",2018-12-01,"Colima",9,0,0,0
"746",2018-12-01,"Durango",10,0,0,0
"747",2018-12-01,"Guanajuato",11,0,0,0
"748",2018-12-01,"Guerrero",12,0,1,1
"749",2018-12-01,"Hidalgo",13,0,0,0
"750",2018-12-01,"Jalisco",14,0,0,0
"751",2018-12-01,"México",15,0,0,0
"752",2018-12-01,"Michoacán",16,0,0,0
"753",2018-12-01,"Morelos",17,0,0,0
"754",2018-12-01,"Nayarit",18,0,0,0
"755",2018-12-01,"Nuevo León",19,0,0,0
"756",2018-12-01,"Oaxaca",20,0,0,0
"757",2018-12-01,"Puebla",21,0,0,0
"758",2018-12-01,"Querétaro",22,0,0,0
"759",2018-12-01,"Quintana Roo",23,0,0,0
"760",2018-12-01,"San Luis Potosí",24,1,1,2
"761",2018-12-01,"Sinaloa",25,71,43,114
"762",2018-12-01,"Sonora",26,0,0,0
"763",2018-12-01,"Tabasco",27,2,2,4
"764",2018-12-01,"Tamaulipas",28,4,0,4
"765",2018-12-01,"Tlaxcala",29,0,0,0
"766",2018-12-01,"Veracruz",30,0,0,0
"767",2018-12-01,"Yucatán",31,0,0,0
"768",2018-12-01,"Zacatecas",32,0,0,0
"769",2019-01-01,"Aguascalientes",1,0,0,0
"770",2019-01-01,"Baja California",2,0,0,0
"771",2019-01-01,"Baja California Sur",3,0,0,0
"772",2019-01-01,"Campeche",4,1,1,2
"773",2019-01-01,"Chiapas",5,0,0,0
"774",2019-01-01,"Chihuahua",6,0,0,0
"775",2019-01-01,"Ciudad de México",7,277,52,329
"776",2019-01-01,"Coahuila",8,1,7,8
"777",2019-01-01,"Colima",9,0,0,0
"778",2019-01-01,"Durango",10,0,0,0
"779",2019-01-01,"Guanajuato",11,0,0,0
"780",2019-01-01,"Guerrero",12,1,2,3
"781",2019-01-01,"Hidalgo",13,0,2,2
"782",2019-01-01,"Jalisco",14,0,0,0
"783",2019-01-01,"México",15,0,0,0
"784",2019-01-01,"Michoacán",16,0,0,0
"785",2019-01-01,"Morelos",17,0,0,0
"786",2019-01-01,"Nayarit",18,0,0,0
"787",2019-01-01,"Nuevo León",19,0,0,0
"788",2019-01-01,"Oaxaca",20,0,0,0
"789",2019-01-01,"Puebla",21,0,0,0
"790",2019-01-01,"Querétaro",22,0,0,0
"791",2019-01-01,"Quintana Roo",23,0,0,0
"792",2019-01-01,"San Luis Potosí",24,0,0,0
"793",2019-01-01,"Sinaloa",25,0,0,0
"794",2019-01-01,"Sonora",26,0,0,0
"795",2019-01-01,"Tabasco",27,0,1,1
"796",2019-01-01,"Tamaulipas",28,0,0,0
"797",2019-01-01,"Tlaxcala",29,0,0,0
"798",2019-01-01,"Veracruz",30,0,0,0
"799",2019-01-01,"Yucatán",31,0,2,2
"800",2019-01-01,"Zacatecas",32,0,0,0
"801",2019-02-01,"Aguascalientes",1,0,0,0
"802",2019-02-01,"Baja California",2,0,0,0
"803",2019-02-01,"Baja California Sur",3,0,0,0
"804",2019-02-01,"Campeche",4,0,0,0
"805",2019-02-01,"Chiapas",5,0,0,0
"806",2019-02-01,"Chihuahua",6,1,0,1
"807",2019-02-01,"Ciudad de México",7,318,50,368
"808",2019-02-01,"Coahuila",8,9,8,17
"809",2019-02-01,"Colima",9,0,0,0
"810",2019-02-01,"Durango",10,3,1,4
"811",2019-02-01,"Guanajuato",11,14,4,18
"812",2019-02-01,"Guerrero",12,1,4,5
"813",2019-02-01,"Hidalgo",13,0,0,0
"814",2019-02-01,"Jalisco",14,0,0,0
"815",2019-02-01,"México",15,0,0,0
"816",2019-02-01,"Michoacán",16,0,0,0
"817",2019-02-01,"Morelos",17,0,0,0
"818",2019-02-01,"Nayarit",18,0,0,0
"819",2019-02-01,"Nuevo León",19,0,0,0
"820",2019-02-01,"Oaxaca",20,0,0,0
"821",2019-02-01,"Puebla",21,0,0,0
"822",2019-02-01,"Querétaro",22,0,0,0
"823",2019-02-01,"Quintana Roo",23,0,0,0
"824",2019-02-01,"San Luis Potosí",24,0,0,0
"825",2019-02-01,"Sinaloa",25,0,0,0
"826",2019-02-01,"Sonora",26,0,0,0
"827",2019-02-01,"Tabasco",27,0,0,0
"828",2019-02-01,"Tamaulipas",28,0,0,0
"829",2019-02-01,"Tlaxcala",29,0,0,0
"830",2019-02-01,"Veracruz",30,0,0,0
"831",2019-02-01,"Yucatán",31,0,0,0
"832",2019-02-01,"Zacatecas",32,31,12,43
"833",2019-03-01,"Aguascalientes",1,0,0,0
"834",2019-03-01,"Baja California",2,0,0,0
"835",2019-03-01,"Baja California Sur",3,0,0,0
"836",2019-03-01,"Campeche",4,0,0,0
"837",2019-03-01,"Chiapas",5,45,27,72
"838",2019-03-01,"Chihuahua",6,49,14,63
"839",2019-03-01,"Ciudad de México",7,767,55,822
"840",2019-03-01,"Coahuila",8,24,22,46
"841",2019-03-01,"Colima",9,0,0,0
"842",2019-03-01,"Durango",10,4,0,4
"843",2019-03-01,"Guanajuato",11,7,5,12
"844",2019-03-01,"Guerrero",12,0,0,0
"845",2019-03-01,"Hidalgo",13,0,0,0
"846",2019-03-01,"Jalisco",14,1,1,2
"847",2019-03-01,"México",15,0,0,0
"848",2019-03-01,"Michoacán",16,0,0,0
"849",2019-03-01,"Morelos",17,0,0,0
"850",2019-03-01,"Nayarit",18,0,0,0
"851",2019-03-01,"Nuevo León",19,0,0,0
"852",2019-03-01,"Oaxaca",20,0,0,0
"853",2019-03-01,"Puebla",21,0,0,0
"854",2019-03-01,"Querétaro",22,0,0,0
"855",2019-03-01,"Quintana Roo",23,1,1,2
"856",2019-03-01,"San Luis Potosí",24,17,14,31
"857",2019-03-01,"Sinaloa",25,0,0,0
"858",2019-03-01,"Sonora",26,0,0,0
"859",2019-03-01,"Tabasco",27,0,0,0
"860",2019-03-01,"Tamaulipas",28,0,0,0
"861",2019-03-01,"Tlaxcala",29,0,0,0
"862",2019-03-01,"Veracruz",30,2,2,4
"863",2019-03-01,"Yucatán",31,0,0,0
"864",2019-03-01,"Zacatecas",32,28,10,38
"865",2019-04-01,"Aguascalientes",1,0,0,0
"866",2019-04-01,"Baja California",2,0,0,0
"867",2019-04-01,"Baja California Sur",3,0,0,0
"868",2019-04-01,"Campeche",4,0,0,0
"869",2019-04-01,"Chiapas",5,0,0,0
"870",2019-04-01,"Chihuahua",6,36,28,64
"871",2019-04-01,"Ciudad de México",7,269,93,362
"872",2019-04-01,"Coahuila",8,7,8,15
"873",2019-04-01,"Colima",9,0,0,0
"874",2019-04-01,"Durango",10,0,0,0
"875",2019-04-01,"Guanajuato",11,0,0,0
"876",2019-04-01,"Guerrero",12,0,0,0
"877",2019-04-01,"Hidalgo",13,0,0,0
"878",2019-04-01,"Jalisco",14,0,0,0
"879",2019-04-01,"México",15,0,0,0
"880",2019-04-01,"Michoacán",16,0,0,0
"881",2019-04-01,"Morelos",17,0,0,0
"882",2019-04-01,"Nayarit",18,0,0,0
"883",2019-04-01,"Nuevo León",19,0,0,0
"884",2019-04-01,"Oaxaca",20,0,0,0
"885",2019-04-01,"Puebla",21,0,0,0
"886",2019-04-01,"Querétaro",22,0,0,0
"887",2019-04-01,"Quintana Roo",23,0,0,0
"888",2019-04-01,"San Luis Potosí",24,19,7,26
"889",2019-04-01,"Sinaloa",25,0,0,0
"890",2019-04-01,"Sonora",26,0,0,0
"891",2019-04-01,"Tabasco",27,0,0,0
"892",2019-04-01,"Tamaulipas",28,0,0,0
"893",2019-04-01,"Tlaxcala",29,0,0,0
"894",2019-04-01,"Veracruz",30,1,1,2
"895",2019-04-01,"Yucatán",31,0,0,0
"896",2019-04-01,"Zacatecas",32,17,18,35
"897",2019-05-01,"Aguascalientes",1,0,0,0
"898",2019-05-01,"Baja California",2,0,0,0
"899",2019-05-01,"Baja California Sur",3,0,0,0
"900",2019-05-01,"Campeche",4,0,0,0
"901",2019-05-01,"Chiapas",5,0,0,0
"902",2019-05-01,"Chihuahua",6,73,53,126
"903",2019-05-01,"Ciudad de México",7,994,83,1077
"904",2019-05-01,"Coahuila",8,15,8,23
"905",2019-05-01,"Colima",9,0,0,0
"906",2019-05-01,"Durango",10,0,0,0
"907",2019-05-01,"Guanajuato",11,0,0,0
"908",2019-05-01,"Guerrero",12,0,0,0
"909",2019-05-01,"Hidalgo",13,0,0,0
"910",2019-05-01,"Jalisco",14,0,0,0
"911",2019-05-01,"México",15,6,0,6
"912",2019-05-01,"Michoacán",16,0,0,0
"913",2019-05-01,"Morelos",17,0,0,0
"914",2019-05-01,"Nayarit",18,0,0,0
"915",2019-05-01,"Nuevo León",19,0,0,0
"916",2019-05-01,"Oaxaca",20,0,0,0
"917",2019-05-01,"Puebla",21,0,0,0
"918",2019-05-01,"Querétaro",22,7,3,10
"919",2019-05-01,"Quintana Roo",23,0,0,0
"920",2019-05-01,"San Luis Potosí",24,0,0,0
"921",2019-05-01,"Sinaloa",25,0,0,0
"922",2019-05-01,"Sonora",26,0,0,0
"923",2019-05-01,"Tabasco",27,1,0,1
"924",2019-05-01,"Tamaulipas",28,0,0,0
"925",2019-05-01,"Tlaxcala",29,0,0,0
"926",2019-05-01,"Veracruz",30,2,1,3
"927",2019-05-01,"Yucatán",31,0,0,0
"928",2019-05-01,"Zacatecas",32,18,9,27
"929",2019-06-01,"Aguascalientes",1,0,0,0
"930",2019-06-01,"Baja California",2,0,0,0
"931",2019-06-01,"Baja California Sur",3,0,0,0
"932",2019-06-01,"Campeche",4,0,0,0
"933",2019-06-01,"Chiapas",5,0,1,1
"934",2019-06-01,"Chihuahua",6,5,3,8
"935",2019-06-01,"Ciudad de México",7,191,64,255
"936",2019-06-01,"Coahuila",8,8,4,12
"937",2019-06-01,"Colima",9,1,0,1
"938",2019-06-01,"Durango",10,9,8,17
"939",2019-06-01,"Guanajuato",11,0,0,0
"940",2019-06-01,"Guerrero",12,0,0,0
"941",2019-06-01,"Hidalgo",13,0,0,0
"942",2019-06-01,"Jalisco",14,0,0,0
"943",2019-06-01,"México",15,22,11,33
"944",2019-06-01,"Michoacán",16,0,0,0
"945",2019-06-01,"Morelos",17,0,0,0
"946",2019-06-01,"Nayarit",18,0,0,0
"947",2019-06-01,"Nuevo León",19,0,0,0
"948",2019-06-01,"Oaxaca",20,0,0,0
"949",2019-06-01,"Puebla",21,0,0,0
"950",2019-06-01,"Querétaro",22,15,10,25
"951",2019-06-01,"Quintana Roo",23,3,1,4
"952",2019-06-01,"San Luis Potosí",24,0,0,0
"953",2019-06-01,"Sinaloa",25,0,0,0
"954",2019-06-01,"Sonora",26,0,0,0
"955",2019-06-01,"Tabasco",27,0,0,0
"956",2019-06-01,"Tamaulipas",28,0,0,0
"957",2019-06-01,"Tlaxcala",29,0,0,0
"958",2019-06-01,"Veracruz",30,7,3,10
"959",2019-06-01,"Yucatán",31,0,0,0
"960",2019-06-01,"Zacatecas",32,13,4,17
"961",2019-07-01,"Aguascalientes",1,16,6,22
"962",2019-07-01,"Baja California",2,0,0,0
"963",2019-07-01,"Baja California Sur",3,0,0,0
"964",2019-07-01,"Campeche",4,0,0,0
"965",2019-07-01,"Chiapas",5,0,0,0
"966",2019-07-01,"Chihuahua",6,45,11,56
"967",2019-07-01,"Ciudad de México",7,114,31,145
"968",2019-07-01,"Coahuila",8,15,7,22
"969",2019-07-01,"Colima",9,0,0,0
"970",2019-07-01,"Durango",10,5,1,6
"971",2019-07-01,"Guanajuato",11,0,0,0
"972",2019-07-01,"Guerrero",12,0,0,0
"973",2019-07-01,"Hidalgo",13,0,0,0
"974",2019-07-01,"Jalisco",14,8,3,11
"975",2019-07-01,"México",15,0,0,0
"976",2019-07-01,"Michoacán",16,0,0,0
"977",2019-07-01,"Morelos",17,9,1,10
"978",2019-07-01,"Nayarit",18,40,9,49
"979",2019-07-01,"Nuevo León",19,0,0,0
"980",2019-07-01,"Oaxaca",20,0,0,0
"981",2019-07-01,"Puebla",21,0,0,0
"982",2019-07-01,"Querétaro",22,0,0,0
"983",2019-07-01,"Quintana Roo",23,2,0,2
"984",2019-07-01,"San Luis Potosí",24,0,0,0
"985",2019-07-01,"Sinaloa",25,0,0,0
"986",2019-07-01,"Sonora",26,0,0,0
"987",2019-07-01,"Tabasco",27,0,0,0
"988",2019-07-01,"Tamaulipas",28,0,0,0
"989",2019-07-01,"Tlaxcala",29,0,0,0
"990",2019-07-01,"Veracruz",30,7,4,11
"991",2019-07-01,"Yucatán",31,0,0,0
"992",2019-07-01,"Zacatecas",32,14,6,20
"993",2019-08-01,"Aguascalientes",1,18,4,22
"994",2019-08-01,"Baja California",2,0,0,0
"995",2019-08-01,"Baja California Sur",3,1,0,1
"996",2019-08-01,"Campeche",4,0,0,0
"997",2019-08-01,"Chiapas",5,0,0,0
"998",2019-08-01,"Chihuahua",6,10,7,17
"999",2019-08-01,"Ciudad de México",7,211,49,260
"1000",2019-08-01,"Coahuila",8,4,1,5
"1001",2019-08-01,"Colima",9,1,0,1
"1002",2019-08-01,"Durango",10,0,0,0
"1003",2019-08-01,"Guanajuato",11,21,6,27
"1004",2019-08-01,"Guerrero",12,0,0,0
"1005",2019-08-01,"Hidalgo",13,0,0,0
"1006",2019-08-01,"Jalisco",14,13,6,19
"1007",2019-08-01,"México",15,115,44,159
"1008",2019-08-01,"Michoacán",16,0,0,0
"1009",2019-08-01,"Morelos",17,36,13,49
"1010",2019-08-01,"Nayarit",18,36,11,47
"1011",2019-08-01,"Nuevo León",19,0,0,0
"1012",2019-08-01,"Oaxaca",20,0,0,0
"1013",2019-08-01,"Puebla",21,0,0,0
"1014",2019-08-01,"Querétaro",22,45,28,73
"1015",2019-08-01,"Quintana Roo",23,1,0,1
"1016",2019-08-01,"San Luis Potosí",24,40,6,46
"1017",2019-08-01,"Sinaloa",25,0,0,0
"1018",2019-08-01,"Sonora",26,0,0,0
"1019",2019-08-01,"Tabasco",27,0,0,0
"1020",2019-08-01,"Tamaulipas",28,38,14,52
"1021",2019-08-01,"Tlaxcala",29,13,7,20
"1022",2019-08-01,"Veracruz",30,8,5,13
"1023",2019-08-01,"Yucatán",31,0,0,0
"1024",2019-08-01,"Zacatecas",32,7,0,7
"1025",2019-09-01,"Aguascalientes",1,4,0,4
"1026",2019-09-01,"Baja California",2,0,0,0
"1027",2019-09-01,"Baja California Sur",3,0,0,0
"1028",2019-09-01,"Campeche",4,0,0,0
"1029",2019-09-01,"Chiapas",5,15,4,19
"1030",2019-09-01,"Chihuahua",6,0,0,0
"1031",2019-09-01,"Ciudad de México",7,173,55,228
"1032",2019-09-01,"Coahuila",8,1,2,3
"1033",2019-09-01,"Colima",9,4,10,14
"1034",2019-09-01,"Durango",10,0,0,0
"1035",2019-09-01,"Guanajuato",11,10,9,19
"1036",2019-09-01,"Guerrero",12,0,0,0
"1037",2019-09-01,"Hidalgo",13,0,0,0
"1038",2019-09-01,"Jalisco",14,1,0,1
"1039",2019-09-01,"México",15,158,34,192
"1040",2019-09-01,"Michoacán",16,0,0,0
"1041",2019-09-01,"Morelos",17,8,2,10
"1042",2019-09-01,"Nayarit",18,3,2,5
"1043",2019-09-01,"Nuevo León",19,0,0,0
"1044",2019-09-01,"Oaxaca",20,0,0,0
"1045",2019-09-01,"Puebla",21,0,0,0
"1046",2019-09-01,"Querétaro",22,0,0,0
"1047",2019-09-01,"Quintana Roo",23,0,0,0
"1048",2019-09-01,"San Luis Potosí",24,8,3,11
"1049",2019-09-01,"Sinaloa",25,0,0,0
"1050",2019-09-01,"Sonora",26,0,0,0
"1051",2019-09-01,"Tabasco",27,0,0,0
"1052",2019-09-01,"Tamaulipas",28,52,22,74
"1053",2019-09-01,"Tlaxcala",29,12,12,24
"1054",2019-09-01,"Veracruz",30,0,0,0
"1055",2019-09-01,"Yucatán",31,0,0,0
"1056",2019-09-01,"Zacatecas",32,2,1,3
"1057",2019-10-01,"Aguascalientes",1,0,0,0
"1058",2019-10-01,"Baja California",2,0,0,0
"1059",2019-10-01,"Baja California Sur",3,3,0,3
"1060",2019-10-01,"Campeche",4,0,0,0
"1061",2019-10-01,"Chiapas",5,5,6,11
"1062",2019-10-01,"Chihuahua",6,0,0,0
"1063",2019-10-01,"Ciudad de México",7,123,84,207
"1064",2019-10-01,"Coahuila",8,1,0,1
"1065",2019-10-01,"Colima",9,1,1,2
"1066",2019-10-01,"Durango",10,0,0,0
"1067",2019-10-01,"Guanajuato",11,0,0,0
"1068",2019-10-01,"Guerrero",12,0,0,0
"1069",2019-10-01,"Hidalgo",13,0,0,0
"1070",2019-10-01,"Jalisco",14,0,0,0
"1071",2019-10-01,"México",15,156,64,220
"1072",2019-10-01,"Michoacán",16,0,0,0
"1073",2019-10-01,"Morelos",17,5,0,5
"1074",2019-10-01,"Nayarit",18,0,0,0
"1075",2019-10-01,"Nuevo León",19,0,0,0
"1076",2019-10-01,"Oaxaca",20,0,0,0
"1077",2019-10-01,"Puebla",21,0,0,0
"1078",2019-10-01,"Querétaro",22,0,0,0
"1079",2019-10-01,"Quintana Roo",23,0,0,0
"1080",2019-10-01,"San Luis Potosí",24,0,0,0
"1081",2019-10-01,"Sinaloa",25,0,0,0
"1082",2019-10-01,"Sonora",26,0,0,0
"1083",2019-10-01,"Tabasco",27,2,0,2
"1084",2019-10-01,"Tamaulipas",28,14,4,18
"1085",2019-10-01,"Tlaxcala",29,12,4,16
"1086",2019-10-01,"Veracruz",30,9,0,9
"1087",2019-10-01,"Yucatán",31,0,0,0
"1088",2019-10-01,"Zacatecas",32,11,2,13
"1089",2019-11-01,"Aguascalientes",1,0,0,0
"1090",2019-11-01,"Baja California",2,0,0,0
"1091",2019-11-01,"Baja California Sur",3,0,0,0
"1092",2019-11-01,"Campeche",4,0,0,0
"1093",2019-11-01,"Chiapas",5,21,27,48
"1094",2019-11-01,"Chihuahua",6,0,1,1
"1095",2019-11-01,"Ciudad de México",7,111,100,211
"1096",2019-11-01,"Coahuila",8,1,0,1
"1097",2019-11-01,"Colima",9,0,0,0
"1098",2019-11-01,"Durango",10,0,0,0
"1099",2019-11-01,"Guanajuato",11,15,15,30
"1100",2019-11-01,"Guerrero",12,0,0,0
"1101",2019-11-01,"Hidalgo",13,1,1,2
"1102",2019-11-01,"Jalisco",14,0,0,0
"1103",2019-11-01,"México",15,109,39,148
"1104",2019-11-01,"Michoacán",16,0,0,0
"1105",2019-11-01,"Morelos",17,4,2,6
"1106",2019-11-01,"Nayarit",18,0,0,0
"1107",2019-11-01,"Nuevo León",19,0,0,0
"1108",2019-11-01,"Oaxaca",20,0,0,0
"1109",2019-11-01,"Puebla",21,0,0,0
"1110",2019-11-01,"Querétaro",22,0,0,0
"1111",2019-11-01,"Quintana Roo",23,0,0,0
"1112",2019-11-01,"San Luis Potosí",24,6,2,8
"1113",2019-11-01,"Sinaloa",25,0,0,0
"1114",2019-11-01,"Sonora",26,0,0,0
"1115",2019-11-01,"Tabasco",27,2,1,3
"1116",2019-11-01,"Tamaulipas",28,0,0,0
"1117",2019-11-01,"Tlaxcala",29,12,1,13
"1118",2019-11-01,"Veracruz",30,1,3,4
"1119",2019-11-01,"Yucatán",31,0,0,0
"1120",2019-11-01,"Zacatecas",32,12,3,15
"1121",2019-12-01,"Aguascalientes",1,0,0,0
"1122",2019-12-01,"Baja California",2,2,1,3
"1123",2019-12-01,"Baja California Sur",3,0,0,0
"1124",2019-12-01,"Campeche",4,0,0,0
"1125",2019-12-01,"Chiapas",5,0,0,0
"1126",2019-12-01,"Chihuahua",6,0,0,0
"1127",2019-12-01,"Ciudad de México",7,51,125,176
"1128",2019-12-01,"Coahuila",8,1,0,1
"1129",2019-12-01,"Colima",9,0,0,0
"1130",2019-12-01,"Durango",10,0,0,0
"1131",2019-12-01,"Guanajuato",11,26,17,43
"1132",2019-12-01,"Guerrero",12,0,0,0
"1133",2019-12-01,"Hidalgo",13,0,0,0
"1134",2019-12-01,"Jalisco",14,9,8,17
"1135",2019-12-01,"México",15,0,0,0
"1136",2019-12-01,"Michoacán",16,0,0,0
"1137",2019-12-01,"Morelos",17,1,1,2
"1138",2019-12-01,"Nayarit",18,0,0,0
"1139",2019-12-01,"Nuevo León",19,11,1,12
"1140",2019-12-01,"Oaxaca",20,0,0,0
"1141",2019-12-01,"Puebla",21,0,0,0
"1142",2019-12-01,"Querétaro",22,0,0,0
"1143",2019-12-01,"Quintana Roo",23,0,0,0
"1144",2019-12-01,"San Luis Potosí",24,26,7,33
"1145",2019-12-01,"Sinaloa",25,0,0,0
"1146",2019-12-01,"Sonora",26,2,0,2
"1147",2019-12-01,"Tabasco",27,0,0,0
"1148",2019-12-01,"Tamaulipas",28,0,0,0
"1149",2019-12-01,"Tlaxcala",29,0,0,0
"1150",2019-12-01,"Veracruz",30,0,0,0
"1151",2019-12-01,"Yucatán",31,0,0,0
"1152",2019-12-01,"Zacatecas",32,19,2,21
"1153",2020-01-01,"Aguascalientes",1,0,0,0
"1154",2020-01-01,"Baja California",2,2,0,2
"1155",2020-01-01,"Baja California Sur",3,0,0,0
"1156",2020-01-01,"Campeche",4,0,0,0
"1157",2020-01-01,"Chiapas",5,9,9,18
"1158",2020-01-01,"Chihuahua",6,0,0,0
"1159",2020-01-01,"Ciudad de México",7,110,22,132
"1160",2020-01-01,"Coahuila",8,2,0,2
"1161",2020-01-01,"Colima",9,0,0,0
"1162",2020-01-01,"Durango",10,0,0,0
"1163",2020-01-01,"Guanajuato",11,0,0,0
"1164",2020-01-01,"Guerrero",12,0,0,0
"1165",2020-01-01,"Hidalgo",13,0,0,0
"1166",2020-01-01,"Jalisco",14,0,0,0
"1167",2020-01-01,"México",15,0,0,0
"1168",2020-01-01,"Michoacán",16,0,0,0
"1169",2020-01-01,"Morelos",17,0,0,0
"1170",2020-01-01,"Nayarit",18,0,0,0
"1171",2020-01-01,"Nuevo León",19,0,0,0
"1172",2020-01-01,"Oaxaca",20,0,0,0
"1173",2020-01-01,"Puebla",21,0,0,0
"1174",2020-01-01,"Querétaro",22,0,0,0
"1175",2020-01-01,"Quintana Roo",23,0,0,0
"1176",2020-01-01,"San Luis Potosí",24,0,0,0
"1177",2020-01-01,"Sinaloa",25,0,0,0
"1178",2020-01-01,"Sonora",26,1,0,1
"1179",2020-01-01,"Tabasco",27,0,0,0
"1180",2020-01-01,"Tamaulipas",28,0,0,0
"1181",2020-01-01,"Tlaxcala",29,0,0,0
"1182",2020-01-01,"Veracruz",30,9,2,11
"1183",2020-01-01,"Yucatán",31,0,0,0
"1184",2020-01-01,"Zacatecas",32,10,3,13
"1185",2020-02-01,"Aguascalientes",1,0,0,0
"1186",2020-02-01,"Baja California",2,0,0,0
"1187",2020-02-01,"Baja California Sur",3,0,0,0
"1188",2020-02-01,"Campeche",4,0,0,0
"1189",2020-02-01,"Chiapas",5,3,1,4
"1190",2020-02-01,"Chihuahua",6,3,0,3
"1191",2020-02-01,"Ciudad de México",7,149,55,204
"1192",2020-02-01,"Coahuila",8,40,38,78
"1193",2020-02-01,"Colima",9,0,0,0
"1194",2020-02-01,"Durango",10,0,0,0
"1195",2020-02-01,"Guanajuato",11,0,0,0
"1196",2020-02-01,"Guerrero",12,0,0,0
"1197",2020-02-01,"Hidalgo",13,0,0,0
"1198",2020-02-01,"Jalisco",14,0,0,0
"1199",2020-02-01,"México",15,0,0,0
"1200",2020-02-01,"Michoacán",16,0,0,0
"1201",2020-02-01,"Morelos",17,0,0,0
"1202",2020-02-01,"Nayarit",18,28,7,35
"1203",2020-02-01,"Nuevo León",19,0,0,0
"1204",2020-02-01,"Oaxaca",20,0,0,0
"1205",2020-02-01,"Puebla",21,0,0,0
"1206",2020-02-01,"Querétaro",22,0,0,0
"1207",2020-02-01,"Quintana Roo",23,0,0,0
"1208",2020-02-01,"San Luis Potosí",24,0,0,0
"1209",2020-02-01,"Sinaloa",25,75,61,136
"1210",2020-02-01,"Sonora",26,6,2,8
"1211",2020-02-01,"Tabasco",27,1,1,2
"1212",2020-02-01,"Tamaulipas",28,0,0,0
"1213",2020-02-01,"Tlaxcala",29,0,0,0
"1214",2020-02-01,"Veracruz",30,2,2,4
"1215",2020-02-01,"Yucatán",31,0,0,0
"1216",2020-02-01,"Zacatecas",32,29,5,34
"1217",2020-03-01,"Aguascalientes",1,0,0,0
"1218",2020-03-01,"Baja California",2,0,0,0
"1219",2020-03-01,"Baja California Sur",3,0,0,0
"1220",2020-03-01,"Campeche",4,0,0,0
"1221",2020-03-01,"Chiapas",5,1,3,4
"1222",2020-03-01,"Chihuahua",6,119,38,157
"1223",2020-03-01,"Ciudad de México",7,71,29,100
"1224",2020-03-01,"Coahuila",8,39,22,61
"1225",2020-03-01,"Colima",9,0,0,0
"1226",2020-03-01,"Durango",10,0,0,0
"1227",2020-03-01,"Guanajuato",11,0,0,0
"1228",2020-03-01,"Guerrero",12,0,0,0
"1229",2020-03-01,"Hidalgo",13,0,0,0
"1230",2020-03-01,"Jalisco",14,0,0,0
"1231",2020-03-01,"México",15,0,0,0
"1232",2020-03-01,"Michoacán",16,0,0,0
"1233",2020-03-01,"Morelos",17,0,0,0
"1234",2020-03-01,"Nayarit",18,9,4,13
"1235",2020-03-01,"Nuevo León",19,0,0,0
"1236",2020-03-01,"Oaxaca",20,0,0,0
"1237",2020-03-01,"Puebla",21,0,0,0
"1238",2020-03-01,"Querétaro",22,0,0,0
"1239",2020-03-01,"Quintana Roo",23,0,0,0
"1240",2020-03-01,"San Luis Potosí",24,14,7,21
"1241",2020-03-01,"Sinaloa",25,18,19,37
"1242",2020-03-01,"Sonora",26,2,0,2
"1243",2020-03-01,"Tabasco",27,0,0,0
"1244",2020-03-01,"Tamaulipas",28,0,0,0
"1245",2020-03-01,"Tlaxcala",29,0,0,0
"1246",2020-03-01,"Veracruz",30,90,13,103
"1247",2020-03-01,"Yucatán",31,0,0,0
"1248",2020-03-01,"Zacatecas",32,2,1,3
"1249",2020-04-01,"Aguascalientes",1,0,0,0
"1250",2020-04-01,"Baja California",2,0,0,0
"1251",2020-04-01,"Baja California Sur",3,0,0,0
"1252",2020-04-01,"Campeche",4,0,0,0
"1253",2020-04-01,"Chiapas",5,0,0,0
"1254",2020-04-01,"Chihuahua",6,0,0,0
"1255",2020-04-01,"Ciudad de México",7,0,0,0
"1256",2020-04-01,"Coahuila",8,0,0,0
"1257",2020-04-01,"Colima",9,0,0,0
"1258",2020-04-01,"Durango",10,0,0,0
"1259",2020-04-01,"Guanajuato",11,0,0,0
"1260",2020-04-01,"Guerrero",12,0,0,0
"1261",2020-04-01,"Hidalgo",13,0,0,0
"1262",2020-04-01,"Jalisco",14,0,0,0
"1263",2020-04-01,"México",15,0,0,0
"1264",2020-04-01,"Michoacán",16,0,0,0
"1265",2020-04-01,"Morelos",17,0,0,0
"1266",2020-04-01,"Nayarit",18,0,0,0
"1267",2020-04-01,"Nuevo León",19,0,0,0
"1268",2020-04-01,"Oaxaca",20,0,0,0
"1269",2020-04-01,"Puebla",21,0,0,0
"1270",2020-04-01,"Querétaro",22,0,0,0
"1271",2020-04-01,"Quintana Roo",23,0,0,0
"1272",2020-04-01,"San Luis Potosí",24,0,0,0
"1273",2020-04-01,"Sinaloa",25,0,0,0
"1274",2020-04-01,"Sonora",26,0,0,0
"1275",2020-04-01,"Tabasco",27,0,0,0
"1276",2020-04-01,"Tamaulipas",28,0,0,0
"1277",2020-04-01,"Tlaxcala",29,0,0,0
"1278",2020-04-01,"Veracruz",30,0,0,0
"1279",2020-04-01,"Yucatán",31,0,0,0
"1280",2020-04-01,"Zacatecas",32,0,0,0
"1281",2020-05-01,"Aguascalientes",1,0,0,0
"1282",2020-05-01,"Baja California",2,0,0,0
"1283",2020-05-01,"Baja California Sur",3,0,0,0
"1284",2020-05-01,"Campeche",4,0,0,0
"1285",2020-05-01,"Chiapas",5,0,0,0
"1286",2020-05-01,"Chihuahua",6,0,0,0
"1287",2020-05-01,"Ciudad de México",7,0,0,0
"1288",2020-05-01,"Coahuila",8,0,0,0
"1289",2020-05-01,"Colima",9,0,0,0
"1290",2020-05-01,"Durango",10,0,0,0
"1291",2020-05-01,"Guanajuato",11,0,0,0
"1292",2020-05-01,"Guerrero",12,0,0,0
"1293",2020-05-01,"Hidalgo",13,0,0,0
"1294",2020-05-01,"Jalisco",14,0,0,0
"1295",2020-05-01,"México",15,0,0,0
"1296",2020-05-01,"Michoacán",16,0,0,0
"1297",2020-05-01,"Morelos",17,0,0,0
"1298",2020-05-01,"Nayarit",18,0,0,0
"1299",2020-05-01,"Nuevo León",19,0,0,0
"1300",2020-05-01,"Oaxaca",20,0,0,0
"1301",2020-05-01,"Puebla",21,0,0,0
"1302",2020-05-01,"Querétaro",22,0,0,0
"1303",2020-05-01,"Quintana Roo",23,0,0,0
"1304",2020-05-01,"San Luis Potosí",24,0,0,0
"1305",2020-05-01,"Sinaloa",25,0,0,0
"1306",2020-05-01,"Sonora",26,0,0,0
"1307",2020-05-01,"Tabasco",27,0,0,0
"1308",2020-05-01,"Tamaulipas",28,0,0,0
"1309",2020-05-01,"Tlaxcala",29,0,0,0
"1310",2020-05-01,"Veracruz",30,0,0,0
"1311",2020-05-01,"Yucatán",31,0,0,0
"1312",2020-05-01,"Zacatecas",32,0,0,0
"1313",2020-06-01,"Aguascalientes",1,0,0,0
"1314",2020-06-01,"Baja California",2,0,0,0
"1315",2020-06-01,"Baja California Sur",3,0,0,0
"1316",2020-06-01,"Campeche",4,0,0,0
"1317",2020-06-01,"Chiapas",5,0,0,0
"1318",2020-06-01,"Chihuahua",6,0,0,0
"1319",2020-06-01,"Ciudad de México",7,0,0,0
"1320",2020-06-01,"Coahuila",8,0,0,0
"1321",2020-06-01,"Colima",9,0,0,0
"1322",2020-06-01,"Durango",10,0,0,0
"1323",2020-06-01,"Guanajuato",11,0,0,0
"1324",2020-06-01,"Guerrero",12,0,0,0
"1325",2020-06-01,"Hidalgo",13,0,0,0
"1326",2020-06-01,"Jalisco",14,0,0,0
"1327",2020-06-01,"México",15,0,0,0
"1328",2020-06-01,"Michoacán",16,0,0,0
"1329",2020-06-01,"Morelos",17,0,0,0
"1330",2020-06-01,"Nayarit",18,0,0,0
"1331",2020-06-01,"Nuevo León",19,0,0,0
"1332",2020-06-01,"Oaxaca",20,0,0,0
"1333",2020-06-01,"Puebla",21,0,0,0
"1334",2020-06-01,"Querétaro",22,0,0,0
"1335",2020-06-01,"Quintana Roo",23,0,0,0
"1336",2020-06-01,"San Luis Potosí",24,0,0,0
"1337",2020-06-01,"Sinaloa",25,0,0,0
"1338",2020-06-01,"Sonora",26,0,0,0
"1339",2020-06-01,"Tabasco",27,0,0,0
"1340",2020-06-01,"Tamaulipas",28,0,0,0
"1341",2020-06-01,"Tlaxcala",29,0,0,0
"1342",2020-06-01,"Veracruz",30,0,0,0
"1343",2020-06-01,"Yucatán",31,0,0,0
"1344",2020-06-01,"Zacatecas",32,0,0,0
"1345",2020-07-01,"Aguascalientes",1,0,0,0
"1346",2020-07-01,"Baja California",2,0,0,0
"1347",2020-07-01,"Baja California Sur",3,0,0,0
"1348",2020-07-01,"Campeche",4,0,0,0
"1349",2020-07-01,"Chiapas",5,0,0,0
"1350",2020-07-01,"Chihuahua",6,0,0,0
"1351",2020-07-01,"Ciudad de México",7,57,28,85
"1352",2020-07-01,"Coahuila",8,0,0,0
"1353",2020-07-01,"Colima",9,0,0,0
"1354",2020-07-01,"Durango",10,0,0,0
"1355",2020-07-01,"Guanajuato",11,0,0,0
"1356",2020-07-01,"Guerrero",12,0,0,0
"1357",2020-07-01,"Hidalgo",13,0,0,0
"1358",2020-07-01,"Jalisco",14,0,0,0
"1359",2020-07-01,"México",15,0,0,0
"1360",2020-07-01,"Michoacán",16,0,0,0
"1361",2020-07-01,"Morelos",17,0,0,0
"1362",2020-07-01,"Nayarit",18,0,0,0
"1363",2020-07-01,"Nuevo León",19,0,0,0
"1364",2020-07-01,"Oaxaca",20,0,0,0
"1365",2020-07-01,"Puebla",21,0,0,0
"1366",2020-07-01,"Querétaro",22,0,0,0
"1367",2020-07-01,"Quintana Roo",23,0,0,0
"1368",2020-07-01,"San Luis Potosí",24,0,0,0
"1369",2020-07-01,"Sinaloa",25,0,0,0
"1370",2020-07-01,"Sonora",26,0,0,0
"1371",2020-07-01,"Tabasco",27,0,0,0
"1372",2020-07-01,"Tamaulipas",28,0,0,0
"1373",2020-07-01,"Tlaxcala",29,0,0,0
"1374",2020-07-01,"Veracruz",30,0,0,0
"1375",2020-07-01,"Yucatán",31,0,0,0
"1376",2020-07-01,"Zacatecas",32,0,0,0
"1377",2020-08-01,"Aguascalientes",1,0,0,0
"1378",2020-08-01,"Baja California",2,0,0,0
"1379",2020-08-01,"Baja California Sur",3,0,0,0
"1380",2020-08-01,"Campeche",4,0,0,0
"1381",2020-08-01,"Chiapas",5,0,0,0
"1382",2020-08-01,"Chihuahua",6,0,0,0
"1383",2020-08-01,"Ciudad de México",7,34,11,45
"1384",2020-08-01,"Coahuila",8,0,0,0
"1385",2020-08-01,"Colima",9,0,0,0
"1386",2020-08-01,"Durango",10,0,0,0
"1387",2020-08-01,"Guanajuato",11,0,0,0
"1388",2020-08-01,"Guerrero",12,0,0,0
"1389",2020-08-01,"Hidalgo",13,0,0,0
"1390",2020-08-01,"Jalisco",14,0,0,0
"1391",2020-08-01,"México",15,0,0,0
"1392",2020-08-01,"Michoacán",16,0,0,0
"1393",2020-08-01,"Morelos",17,0,0,0
"1394",2020-08-01,"Nayarit",18,0,0,0
"1395",2020-08-01,"Nuevo León",19,0,0,0
"1396",2020-08-01,"Oaxaca",20,0,0,0
"1397",2020-08-01,"Puebla",21,0,0,0
"1398",2020-08-01,"Querétaro",22,0,0,0
"1399",2020-08-01,"Quintana Roo",23,0,0,0
"1400",2020-08-01,"San Luis Potosí",24,0,0,0
"1401",2020-08-01,"Sinaloa",25,0,0,0
"1402",2020-08-01,"Sonora",26,0,0,0
"1403",2020-08-01,"Tabasco",27,0,0,0
"1404",2020-08-01,"Tamaulipas",28,0,0,0
"1405",2020-08-01,"Tlaxcala",29,0,0,0
"1406",2020-08-01,"Veracruz",30,0,0,0
"1407",2020-08-01,"Yucatán",31,0,0,0
"1408",2020-08-01,"Zacatecas",32,0,0,0
"1409",2020-09-01,"Aguascalientes",1,0,0,0
"1410",2020-09-01,"Baja California",2,0,0,0
"1411",2020-09-01,"Baja California Sur",3,0,0,0
"1412",2020-09-01,"Campeche",4,0,0,0
"1413",2020-09-01,"Chiapas",5,0,0,0
"1414",2020-09-01,"Chihuahua",6,0,0,0
"1415",2020-09-01,"Ciudad de México",7,32,13,45
"1416",2020-09-01,"Coahuila",8,0,0,0
"1417",2020-09-01,"Colima",9,0,0,0
"1418",2020-09-01,"Durango",10,0,0,0
"1419",2020-09-01,"Guanajuato",11,0,0,0
"1420",2020-09-01,"Guerrero",12,0,0,0
"1421",2020-09-01,"Hidalgo",13,0,0,0
"1422",2020-09-01,"Jalisco",14,0,0,0
"1423",2020-09-01,"México",15,0,0,0
"1424",2020-09-01,"Michoacán",16,0,0,0
"1425",2020-09-01,"Morelos",17,0,0,0
"1426",2020-09-01,"Nayarit",18,0,0,0
"1427",2020-09-01,"Nuevo León",19,0,0,0
"1428",2020-09-01,"Oaxaca",20,0,0,0
"1429",2020-09-01,"Puebla",21,0,0,0
"1430",2020-09-01,"Querétaro",22,0,0,0
"1431",2020-09-01,"Quintana Roo",23,0,0,0
"1432",2020-09-01,"San Luis Potosí",24,0,0,0
"1433",2020-09-01,"Sinaloa",25,0,0,0
"1434",2020-09-01,"Sonora",26,0,0,0
"1435",2020-09-01,"Tabasco",27,0,0,0
"1436",2020-09-01,"Tamaulipas",28,0,0,0
"1437",2020-09-01,"Tlaxcala",29,0,0,0
"1438",2020-09-01,"Veracruz",30,37,14,51
"1439",2020-09-01,"Yucatán",31,0,0,0
"1440",2020-09-01,"Zacatecas",32,0,0,0
"1441",2020-10-01,"Aguascalientes",1,0,0,0
"1442",2020-10-01,"Baja California",2,0,0,0
"1443",2020-10-01,"Baja California Sur",3,0,0,0
"1444",2020-10-01,"Campeche",4,0,0,0
"1445",2020-10-01,"Chiapas",5,0,0,0
"1446",2020-10-01,"Chihuahua",6,0,0,0
"1447",2020-10-01,"Ciudad de México",7,47,25,72
"1448",2020-10-01,"Coahuila",8,0,0,0
"1449",2020-10-01,"Colima",9,0,0,0
"1450",2020-10-01,"Durango",10,0,0,0
"1451",2020-10-01,"Guanajuato",11,0,0,0
"1452",2020-10-01,"Guerrero",12,0,0,0
"1453",2020-10-01,"Hidalgo",13,0,0,0
"1454",2020-10-01,"Jalisco",14,0,0,0
"1455",2020-10-01,"México",15,0,0,0
"1456",2020-10-01,"Michoacán",16,0,0,0
"1457",2020-10-01,"Morelos",17,0,0,0
"1458",2020-10-01,"Nayarit",18,0,0,0
"1459",2020-10-01,"Nuevo León",19,0,0,0
"1460",2020-10-01,"Oaxaca",20,0,0,0
"1461",2020-10-01,"Puebla",21,0,0,0
"1462",2020-10-01,"Querétaro",22,0,0,0
"1463",2020-10-01,"Quintana Roo",23,0,0,0
"1464",2020-10-01,"San Luis Potosí",24,0,0,0
"1465",2020-10-01,"Sinaloa",25,0,0,0
"1466",2020-10-01,"Sonora",26,0,0,0
"1467",2020-10-01,"Tabasco",27,0,0,0
"1468",2020-10-01,"Tamaulipas",28,0,0,0
"1469",2020-10-01,"Tlaxcala",29,0,0,0
"1470",2020-10-01,"Veracruz",30,9,7,16
"1471",2020-10-01,"Yucatán",31,0,0,0
"1472",2020-10-01,"Zacatecas",32,0,0,0
"1473",2020-11-01,"Aguascalientes",1,0,0,0
"1474",2020-11-01,"Baja California",2,0,0,0
"1475",2020-11-01,"Baja California Sur",3,0,0,0
"1476",2020-11-01,"Campeche",4,0,0,0
"1477",2020-11-01,"Chiapas",5,0,0,0
"1478",2020-11-01,"Chihuahua",6,0,0,0
"1479",2020-11-01,"Ciudad de México",7,37,39,76
"1480",2020-11-01,"Coahuila",8,0,0,0
"1481",2020-11-01,"Colima",9,0,0,0
"1482",2020-11-01,"Durango",10,0,0,0
"1483",2020-11-01,"Guanajuato",11,0,0,0
"1484",2020-11-01,"Guerrero",12,0,0,0
"1485",2020-11-01,"Hidalgo",13,0,0,0
"1486",2020-11-01,"Jalisco",14,0,0,0
"1487",2020-11-01,"México",15,0,0,0
"1488",2020-11-01,"Michoacán",16,0,0,0
"1489",2020-11-01,"Morelos",17,0,0,0
"1490",2020-11-01,"Nayarit",18,0,0,0
"1491",2020-11-01,"Nuevo León",19,0,0,0
"1492",2020-11-01,"Oaxaca",20,0,0,0
"1493",2020-11-01,"Puebla",21,0,0,0
"1494",2020-11-01,"Querétaro",22,0,0,0
"1495",2020-11-01,"Quintana Roo",23,0,0,0
"1496",2020-11-01,"San Luis Potosí",24,0,0,0
"1497",2020-11-01,"Sinaloa",25,0,0,0
"1498",2020-11-01,"Sonora",26,0,0,0
"1499",2020-11-01,"Tabasco",27,0,0,0
"1500",2020-11-01,"Tamaulipas",28,0,0,0
"1501",2020-11-01,"Tlaxcala",29,0,0,0
"1502",2020-11-01,"Veracruz",30,7,1,8
"1503",2020-11-01,"Yucatán",31,0,0,0
"1504",2020-11-01,"Zacatecas",32,0,0,0
"1505",2020-12-01,"Aguascalientes",1,0,0,0
"1506",2020-12-01,"Baja California",2,0,0,0
"1507",2020-12-01,"Baja California Sur",3,0,0,0
"1508",2020-12-01,"Campeche",4,0,0,0
"1509",2020-12-01,"Chiapas",5,0,0,0
"1510",2020-12-01,"Chihuahua",6,0,0,0
"1511",2020-12-01,"Ciudad de México",7,23,53,76
"1512",2020-12-01,"Coahuila",8,0,0,0
"1513",2020-12-01,"Colima",9,0,0,0
"1514",2020-12-01,"Durango",10,0,0,0
"1515",2020-12-01,"Guanajuato",11,0,0,0
"1516",2020-12-01,"Guerrero",12,0,0,0
"1517",2020-12-01,"Hidalgo",13,0,0,0
"1518",2020-12-01,"Jalisco",14,0,0,0
"1519",2020-12-01,"México",15,0,0,0
"1520",2020-12-01,"Michoacán",16,0,0,0
"1521",2020-12-01,"Morelos",17,0,0,0
"1522",2020-12-01,"Nayarit",18,0,0,0
"1523",2020-12-01,"Nuevo León",19,0,0,0
"1524",2020-12-01,"Oaxaca",20,0,0,0
"1525",2020-12-01,"Puebla",21,0,0,0
"1526",2020-12-01,"Querétaro",22,0,0,0
"1527",2020-12-01,"Quintana Roo",23,0,0,0
"1528",2020-12-01,"San Luis Potosí",24,0,0,0
"1529",2020-12-01,"Sinaloa",25,0,0,0
"1530",2020-12-01,"Sonora",26,0,0,0
"1531",2020-12-01,"Tabasco",27,0,0,0
"1532",2020-12-01,"Tamaulipas",28,0,0,0
"1533",2020-12-01,"Tlaxcala",29,0,0,0
"1534",2020-12-01,"Veracruz",30,0,0,0
"1535",2020-12-01,"Yucatán",31,0,0,0
"1536",2020-12-01,"Zacatecas",32,0,0,0
"1537",2021-01-01,"Aguascalientes",1,0,0,0
"1538",2021-01-01,"Baja California",2,0,0,0
"1539",2021-01-01,"Baja California Sur",3,0,0,0
"1540",2021-01-01,"Campeche",4,0,0,0
"1541",2021-01-01,"Chiapas",5,0,0,0
"1542",2021-01-01,"Chihuahua",6,0,0,0
"1543",2021-01-01,"Ciudad de México",7,0,0,0
"1544",2021-01-01,"Coahuila",8,0,0,0
"1545",2021-01-01,"Colima",9,0,0,0
"1546",2021-01-01,"Durango",10,0,0,0
"1547",2021-01-01,"Guanajuato",11,0,0,0
"1548",2021-01-01,"Guerrero",12,0,0,0
"1549",2021-01-01,"Hidalgo",13,0,0,0
"1550",2021-01-01,"Jalisco",14,0,0,0
"1551",2021-01-01,"México",15,0,0,0
"1552",2021-01-01,"Michoacán",16,0,0,0
"1553",2021-01-01,"Morelos",17,0,0,0
"1554",2021-01-01,"Nayarit",18,0,0,0
"1555",2021-01-01,"Nuevo León",19,0,0,0
"1556",2021-01-01,"Oaxaca",20,0,0,0
"1557",2021-01-01,"Puebla",21,0,0,0
"1558",2021-01-01,"Querétaro",22,0,0,0
"1559",2021-01-01,"Quintana Roo",23,0,0,0
"1560",2021-01-01,"San Luis Potosí",24,0,0,0
"1561",2021-01-01,"Sinaloa",25,0,0,0
"1562",2021-01-01,"Sonora",26,0,0,0
"1563",2021-01-01,"Tabasco",27,0,0,0
"1564",2021-01-01,"Tamaulipas",28,0,0,0
"1565",2021-01-01,"Tlaxcala",29,0,0,0
"1566",2021-01-01,"Veracruz",30,0,0,0
"1567",2021-01-01,"Yucatán",31,0,0,0
"1568",2021-01-01,"Zacatecas",32,0,0,0
"1569",2021-02-01,"Aguascalientes",1,0,0,0
"1570",2021-02-01,"Baja California",2,0,0,0
"1571",2021-02-01,"Baja California Sur",3,0,0,0
"1572",2021-02-01,"Campeche",4,0,0,0
"1573",2021-02-01,"Chiapas",5,15,60,75
"1574",2021-02-01,"Chihuahua",6,0,0,0
"1575",2021-02-01,"Ciudad de México",7,0,0,0
"1576",2021-02-01,"Coahuila",8,0,0,0
"1577",2021-02-01,"Colima",9,0,0,0
"1578",2021-02-01,"Durango",10,0,0,0
"1579",2021-02-01,"Guanajuato",11,0,0,0
"1580",2021-02-01,"Guerrero",12,0,0,0
"1581",2021-02-01,"Hidalgo",13,0,0,0
"1582",2021-02-01,"Jalisco",14,0,0,0
"1583",2021-02-01,"México",15,0,0,0
"1584",2021-02-01,"Michoacán",16,0,0,0
"1585",2021-02-01,"Morelos",17,0,0,0
"1586",2021-02-01,"Nayarit",18,0,0,0
"1587",2021-02-01,"Nuevo León",19,0,0,0
"1588",2021-02-01,"Oaxaca",20,0,0,0
"1589",2021-02-01,"Puebla",21,0,0,0
"1590",2021-02-01,"Querétaro",22,0,0,0
"1591",2021-02-01,"Quintana Roo",23,0,0,0
"1592",2021-02-01,"San Luis Potosí",24,0,0,0
"1593",2021-02-01,"Sinaloa",25,0,0,0
"1594",2021-02-01,"Sonora",26,0,0,0
"1595",2021-02-01,"Tabasco",27,0,0,0
"1596",2021-02-01,"Tamaulipas",28,0,0,0
"1597",2021-02-01,"Tlaxcala",29,0,0,0
"1598",2021-02-01,"Veracruz",30,0,0,0
"1599",2021-02-01,"Yucatán",31,0,0,0
"1600",2021-02-01,"Zacatecas",32,0,0,0
"1601",2021-03-01,"Aguascalientes",1,0,0,0
"1602",2021-03-01,"Baja California",2,0,0,0
"1603",2021-03-01,"Baja California Sur",3,0,0,0
"1604",2021-03-01,"Campeche",4,0,0,0
"1605",2021-03-01,"Chiapas",5,0,0,0
"1606",2021-03-01,"Chihuahua",6,0,0,0
"1607",2021-03-01,"Ciudad de México",7,0,0,0
"1608",2021-03-01,"Coahuila",8,0,0,0
"1609",2021-03-01,"Colima",9,0,0,0
"1610",2021-03-01,"Durango",10,0,0,0
"1611",2021-03-01,"Guanajuato",11,0,0,0
"1612",2021-03-01,"Guerrero",12,0,0,0
"1613",2021-03-01,"Hidalgo",13,0,0,0
"1614",2021-03-01,"Jalisco",14,0,0,0
"1615",2021-03-01,"México",15,0,0,0
"1616",2021-03-01,"Michoacán",16,0,0,0
"1617",2021-03-01,"Morelos",17,0,0,0
"1618",2021-03-01,"Nayarit",18,0,0,0
"1619",2021-03-01,"Nuevo León",19,0,0,0
"1620",2021-03-01,"Oaxaca",20,0,0,0
"1621",2021-03-01,"Puebla",21,0,0,0
"1622",2021-03-01,"Querétaro",22,0,0,0
"1623",2021-03-01,"Quintana Roo",23,0,0,0
"1624",2021-03-01,"San Luis Potosí",24,0,0,0
"1625",2021-03-01,"Sinaloa",25,0,0,0
"1626",2021-03-01,"Sonora",26,0,0,0
"1627",2021-03-01,"Tabasco",27,0,0,0
"1628",2021-03-01,"Tamaulipas",28,0,0,0
"1629",2021-03-01,"Tlaxcala",29,0,0,0
"1630",2021-03-01,"Veracruz",30,0,0,0
"1631",2021-03-01,"Yucatán",31,0,0,0
"1632",2021-03-01,"Zacatecas",32,0,0,0
"1633",2021-04-01,"Aguascalientes",1,0,0,0
"1634",2021-04-01,"Baja California",2,0,0,0
"1635",2021-04-01,"Baja California Sur",3,0,0,0
"1636",2021-04-01,"Campeche",4,0,0,0
"1637",2021-04-01,"Chiapas",5,0,0,0
"1638",2021-04-01,"Chihuahua",6,0,0,0
"1639",2021-04-01,"Ciudad de México",7,0,0,0
"1640",2021-04-01,"Coahuila",8,0,0,0
"1641",2021-04-01,"Colima",9,0,0,0
"1642",2021-04-01,"Durango",10,0,0,0
"1643",2021-04-01,"Guanajuato",11,0,0,0
"1644",2021-04-01,"Guerrero",12,0,0,0
"1645",2021-04-01,"Hidalgo",13,0,0,0
"1646",2021-04-01,"Jalisco",14,0,0,0
"1647",2021-04-01,"México",15,0,0,0
"1648",2021-04-01,"Michoacán",16,0,0,0
"1649",2021-04-01,"Morelos",17,0,0,0
"1650",2021-04-01,"Nayarit",18,0,0,0
"1651",2021-04-01,"Nuevo León",19,0,0,0
"1652",2021-04-01,"Oaxaca",20,0,0,0
"1653",2021-04-01,"Puebla",21,0,0,0
"1654",2021-04-01,"Querétaro",22,0,0,0
"1655",2021-04-01,"Quintana Roo",23,0,0,0
"1656",2021-04-01,"San Luis Potosí",24,0,0,0
"1657",2021-04-01,"Sinaloa",25,0,0,0
"1658",2021-04-01,"Sonora",26,0,0,0
"1659",2021-04-01,"Tabasco",27,0,0,0
"1660",2021-04-01,"Tamaulipas",28,0,0,0
"1661",2021-04-01,"Tlaxcala",29,0,0,0
"1662",2021-04-01,"Veracruz",30,0,0,0
"1663",2021-04-01,"Yucatán",31,0,0,0
"1664",2021-04-01,"Zacatecas",32,0,0,0
"1665",2021-05-01,"Aguascalientes",1,0,0,0
"1666",2021-05-01,"Baja California",2,0,0,0
"1667",2021-05-01,"Baja California Sur",3,0,0,0
"1668",2021-05-01,"Campeche",4,0,0,0
"1669",2021-05-01,"Chiapas",5,0,0,0
"1670",2021-05-01,"Chihuahua",6,0,0,0
"1671",2021-05-01,"Ciudad de México",7,0,0,0
"1672",2021-05-01,"Coahuila",8,0,0,0
"1673",2021-05-01,"Colima",9,0,0,0
"1674",2021-05-01,"Durango",10,0,0,0
"1675",2021-05-01,"Guanajuato",11,0,0,0
"1676",2021-05-01,"Guerrero",12,0,0,0
"1677",2021-05-01,"Hidalgo",13,0,0,0
"1678",2021-05-01,"Jalisco",14,0,0,0
"1679",2021-05-01,"México",15,0,0,0
"1680",2021-05-01,"Michoacán",16,0,0,0
"1681",2021-05-01,"Morelos",17,0,0,0
"1682",2021-05-01,"Nayarit",18,0,0,0
"1683",2021-05-01,"Nuevo León",19,0,0,0
"1684",2021-05-01,"Oaxaca",20,0,0,0
"1685",2021-05-01,"Puebla",21,0,0,0
"1686",2021-05-01,"Querétaro",22,0,0,0
"1687",2021-05-01,"Quintana Roo",23,0,0,0
"1688",2021-05-01,"San Luis Potosí",24,0,0,0
"1689",2021-05-01,"Sinaloa",25,0,0,0
"1690",2021-05-01,"Sonora",26,0,0,0
"1691",2021-05-01,"Tabasco",27,0,0,0
"1692",2021-05-01,"Tamaulipas",28,0,0,0
"1693",2021-05-01,"Tlaxcala",29,0,0,0
"1694",2021-05-01,"Veracruz",30,0,0,0
"1695",2021-05-01,"Yucatán",31,0,0,0
"1696",2021-05-01,"Zacatecas",32,0,0,0
"1697",2021-06-01,"Aguascalientes",1,0,0,0
"1698",2021-06-01,"Baja California",2,0,0,0
"1699",2021-06-01,"Baja California Sur",3,0,0,0
"1700",2021-06-01,"Campeche",4,0,0,0
"1701",2021-06-01,"Chiapas",5,0,0,0
"1702",2021-06-01,"Chihuahua",6,0,0,0
"1703",2021-06-01,"Ciudad de México",7,51,11,62
"1704",2021-06-01,"Coahuila",8,0,0,0
"1705",2021-06-01,"Colima",9,0,0,0
"1706",2021-06-01,"Durango",10,0,0,0
"1707",2021-06-01,"Guanajuato",11,0,0,0
"1708",2021-06-01,"Guerrero",12,0,0,0
"1709",2021-06-01,"Hidalgo",13,0,0,0
"1710",2021-06-01,"Jalisco",14,0,0,0
"1711",2021-06-01,"México",15,0,0,0
"1712",2021-06-01,"Michoacán",16,0,0,0
"1713",2021-06-01,"Morelos",17,0,0,0
"1714",2021-06-01,"Nayarit",18,0,0,0
"1715",2021-06-01,"Nuevo León",19,0,0,0
"1716",2021-06-01,"Oaxaca",20,0,0,0
"1717",2021-06-01,"Puebla",21,0,0,0
"1718",2021-06-01,"Querétaro",22,0,0,0
"1719",2021-06-01,"Quintana Roo",23,0,0,0
"1720",2021-06-01,"San Luis Potosí",24,0,0,0
"1721",2021-06-01,"Sinaloa",25,0,0,0
"1722",2021-06-01,"Sonora",26,0,0,0
"1723",2021-06-01,"Tabasco",27,0,0,0
"1724",2021-06-01,"Tamaulipas",28,0,0,0
"1725",2021-06-01,"Tlaxcala",29,0,0,0
"1726",2021-06-01,"Veracruz",30,0,0,0
"1727",2021-06-01,"Yucatán",31,0,0,0
"1728",2021-06-01,"Zacatecas",32,0,0,0
"1729",2021-07-01,"Aguascalientes",1,0,0,0
"1730",2021-07-01,"Baja California",2,0,0,0
"1731",2021-07-01,"Baja California Sur",3,0,0,0
"1732",2021-07-01,"Campeche",4,0,0,0
"1733",2021-07-01,"Chiapas",5,0,0,0
"1734",2021-07-01,"Chihuahua",6,0,0,0
"1735",2021-07-01,"Ciudad de México",7,0,0,0
"1736",2021-07-01,"Coahuila",8,24,17,41
"1737",2021-07-01,"Colima",9,0,0,0
"1738",2021-07-01,"Durango",10,0,0,0
"1739",2021-07-01,"Guanajuato",11,0,0,0
"1740",2021-07-01,"Guerrero",12,0,0,0
"1741",2021-07-01,"Hidalgo",13,0,0,0
"1742",2021-07-01,"Jalisco",14,0,0,0
"1743",2021-07-01,"México",15,0,0,0
"1744",2021-07-01,"Michoacán",16,0,0,0
"1745",2021-07-01,"Morelos",17,0,0,0
"1746",2021-07-01,"Nayarit",18,0,0,0
"1747",2021-07-01,"Nuevo León",19,0,0,0
"1748",2021-07-01,"Oaxaca",20,0,0,0
"1749",2021-07-01,"Puebla",21,0,0,0
"1750",2021-07-01,"Querétaro",22,0,0,0
"1751",2021-07-01,"Quintana Roo",23,0,0,0
"1752",2021-07-01,"San Luis Potosí",24,0,0,0
"1753",2021-07-01,"Sinaloa",25,0,0,0
"1754",2021-07-01,"Sonora",26,0,0,0
"1755",2021-07-01,"Tabasco",27,0,0,0
"1756",2021-07-01,"Tamaulipas",28,0,0,0
"1757",2021-07-01,"Tlaxcala",29,0,0,0
"1758",2021-07-01,"Veracruz",30,41,18,59
"1759",2021-07-01,"Yucatán",31,0,0,0
"1760",2021-07-01,"Zacatecas",32,0,0,0
"1761",2021-08-01,"Aguascalientes",1,0,0,0
"1762",2021-08-01,"Baja California",2,0,0,0
"1763",2021-08-01,"Baja California Sur",3,0,0,0
"1764",2021-08-01,"Campeche",4,0,0,0
"1765",2021-08-01,"Chiapas",5,0,0,0
"1766",2021-08-01,"Chihuahua",6,0,0,0
"1767",2021-08-01,"Ciudad de México",7,21,55,76
"1768",2021-08-01,"Coahuila",8,0,0,0
"1769",2021-08-01,"Colima",9,0,0,0
"1770",2021-08-01,"Durango",10,0,0,0
"1771",2021-08-01,"Guanajuato",11,0,0,0
"1772",2021-08-01,"Guerrero",12,0,0,0
"1773",2021-08-01,"Hidalgo",13,0,0,0
"1774",2021-08-01,"Jalisco",14,0,0,0
"1775",2021-08-01,"México",15,0,0,0
"1776",2021-08-01,"Michoacán",16,0,0,0
"1777",2021-08-01,"Morelos",17,0,0,0
"1778",2021-08-01,"Nayarit",18,0,0,0
"1779",2021-08-01,"Nuevo León",19,0,0,0
"1780",2021-08-01,"Oaxaca",20,0,0,0
"1781",2021-08-01,"Puebla",21,0,0,0
"1782",2021-08-01,"Querétaro",22,0,0,0
"1783",2021-08-01,"Quintana Roo",23,0,0,0
"1784",2021-08-01,"San Luis Potosí",24,0,0,0
"1785",2021-08-01,"Sinaloa",25,0,0,0
"1786",2021-08-01,"Sonora",26,0,0,0
"1787",2021-08-01,"Tabasco",27,0,0,0
"1788",2021-08-01,"Tamaulipas",28,0,0,0
"1789",2021-08-01,"Tlaxcala",29,0,0,0
"1790",2021-08-01,"Veracruz",30,0,0,0
"1791",2021-08-01,"Yucatán",31,0,0,0
"1792",2021-08-01,"Zacatecas",32,0,0,0
"1793",2021-09-01,"Aguascalientes",1,0,0,0
"1794",2021-09-01,"Baja California",2,9,10,19
"1795",2021-09-01,"Baja California Sur",3,0,0,0
"1796",2021-09-01,"Campeche",4,0,0,0
"1797",2021-09-01,"Chiapas",5,0,0,0
"1798",2021-09-01,"Chihuahua",6,24,6,30
"1799",2021-09-01,"Ciudad de México",7,84,17,101
"1800",2021-09-01,"Coahuila",8,0,0,0
"1801",2021-09-01,"Colima",9,0,0,0
"1802",2021-09-01,"Durango",10,0,0,0
"1803",2021-09-01,"Guanajuato",11,5,0,5
"1804",2021-09-01,"Guerrero",12,0,0,0
"1805",2021-09-01,"Hidalgo",13,0,0,0
"1806",2021-09-01,"Jalisco",14,0,0,0
"1807",2021-09-01,"México",15,0,0,0
"1808",2021-09-01,"Michoacán",16,0,0,0
"1809",2021-09-01,"Morelos",17,0,0,0
"1810",2021-09-01,"Nayarit",18,0,0,0
"1811",2021-09-01,"Nuevo León",19,0,0,0
"1812",2021-09-01,"Oaxaca",20,0,0,0
"1813",2021-09-01,"Puebla",21,0,0,0
"1814",2021-09-01,"Querétaro",22,0,0,0
"1815",2021-09-01,"Quintana Roo",23,0,0,0
"1816",2021-09-01,"San Luis Potosí",24,0,0,0
"1817",2021-09-01,"Sinaloa",25,0,0,0
"1818",2021-09-01,"Sonora",26,0,0,0
"1819",2021-09-01,"Tabasco",27,0,0,0
"1820",2021-09-01,"Tamaulipas",28,0,0,0
"1821",2021-09-01,"Tlaxcala",29,0,0,0
"1822",2021-09-01,"Veracruz",30,0,0,0
"1823",2021-09-01,"Yucatán",31,0,0,0
"1824",2021-09-01,"Zacatecas",32,0,0,0
"1825",2021-10-01,"Aguascalientes",1,0,0,0
"1826",2021-10-01,"Baja California",2,4,1,5
"1827",2021-10-01,"Baja California Sur",3,0,0,0
"1828",2021-10-01,"Campeche",4,0,0,0
"1829",2021-10-01,"Chiapas",5,0,0,0
"1830",2021-10-01,"Chihuahua",6,0,0,0
"1831",2021-10-01,"Ciudad de México",7,46,10,56
"1832",2021-10-01,"Coahuila",8,0,0,0
"1833",2021-10-01,"Colima",9,0,0,0
"1834",2021-10-01,"Durango",10,0,0,0
"1835",2021-10-01,"Guanajuato",11,0,0,0
"1836",2021-10-01,"Guerrero",12,0,0,0
"1837",2021-10-01,"Hidalgo",13,0,0,0
"1838",2021-10-01,"Jalisco",14,0,0,0
"1839",2021-10-01,"México",15,0,0,0
"1840",2021-10-01,"Michoacán",16,0,0,0
"1841",2021-10-01,"Morelos",17,0,0,0
"1842",2021-10-01,"Nayarit",18,0,0,0
"1843",2021-10-01,"Nuevo León",19,0,0,0
"1844",2021-10-01,"Oaxaca",20,0,0,0
"1845",2021-10-01,"Puebla",21,0,0,0
"1846",2021-10-01,"Querétaro",22,0,0,0
"1847",2021-10-01,"Quintana Roo",23,0,0,0
"1848",2021-10-01,"San Luis Potosí",24,0,0,0
"1849",2021-10-01,"Sinaloa",25,0,0,0
"1850",2021-10-01,"Sonora",26,0,0,0
"1851",2021-10-01,"Tabasco",27,0,0,0
"1852",2021-10-01,"Tamaulipas",28,0,0,0
"1853",2021-10-01,"Tlaxcala",29,0,0,0
"1854",2021-10-01,"Veracruz",30,0,0,0
"1855",2021-10-01,"Yucatán",31,0,0,0
"1856",2021-10-01,"Zacatecas",32,0,0,0
"1857",2021-11-01,"Aguascalientes",1,0,0,0
"1858",2021-11-01,"Baja California",2,2,1,3
"1859",2021-11-01,"Baja California Sur",3,0,0,0
"1860",2021-11-01,"Campeche",4,0,0,0
"1861",2021-11-01,"Chiapas",5,7,3,10
"1862",2021-11-01,"Chihuahua",6,45,20,65
"1863",2021-11-01,"Ciudad de México",7,48,11,59
"1864",2021-11-01,"Coahuila",8,0,0,0
"1865",2021-11-01,"Colima",9,0,0,0
"1866",2021-11-01,"Durango",10,0,0,0
"1867",2021-11-01,"Guanajuato",11,0,0,0
"1868",2021-11-01,"Guerrero",12,0,0,0
"1869",2021-11-01,"Hidalgo",13,0,0,0
"1870",2021-11-01,"Jalisco",14,0,0,0
"1871",2021-11-01,"México",15,0,0,0
"1872",2021-11-01,"Michoacán",16,0,0,0
"1873",2021-11-01,"Morelos",17,0,0,0
"1874",2021-11-01,"Nayarit",18,0,0,0
"1875",2021-11-01,"Nuevo León",19,0,0,0
"1876",2021-11-01,"Oaxaca",20,0,0,0
"1877",2021-11-01,"Puebla",21,0,0,0
"1878",2021-11-01,"Querétaro",22,0,0,0
"1879",2021-11-01,"Quintana Roo",23,0,0,0
"1880",2021-11-01,"San Luis Potosí",24,0,0,0
"1881",2021-11-01,"Sinaloa",25,0,0,0
"1882",2021-11-01,"Sonora",26,0,0,0
"1883",2021-11-01,"Tabasco",27,0,0,0
"1884",2021-11-01,"Tamaulipas",28,0,0,0
"1885",2021-11-01,"Tlaxcala",29,79,42,121
"1886",2021-11-01,"Veracruz",30,27,6,33
"1887",2021-11-01,"Yucatán",31,0,0,0
"1888",2021-11-01,"Zacatecas",32,0,0,0
